"aa" = (/turf/simulated/open,/area/sector_b)
"ab" = (/turf/simulated/outwards/stone,/area/sector_b)
"ac" = (/obj/structure/catwalk,/turf/simulated/open,/area/sector_b)
"ad" = (/turf/simulated/wall/r_wall,/area/sector_b)
"ae" = (/turf/simulated/floor/tiled/dark,/area/sector_b)
"af" = (/obj/structure/railing,/turf/simulated/open,/area/sector_b)
"ag" = (/obj/machinery/light/small/red{icon_state = "bulb1"; dir = 8},/turf/simulated/floor/tiled/dark,/area/sector_b)
"ah" = (/obj/machinery/light{dir = 1},/turf/simulated/floor/tiled/dark,/area/sector_b)
"ai" = (/obj/machinery/light,/turf/simulated/floor/tiled/dark,/area/sector_b)
"aj" = (/obj/structure/railing{icon_state = "railing0"; dir = 1},/turf/simulated/open,/area/sector_b)
"ak" = (/obj/structure/railing{icon_state = "frontoverlay_l"; dir = 1},/obj/structure/railing{icon_state = "railing1"; dir = 1},/obj/structure/railing{icon_state = "corneroverlay"; dir = 4},/obj/structure/railing{icon_state = "frontoverlay_r"; dir = 4},/obj/structure/railing{icon_state = "railing1"; dir = 4},/turf/simulated/open,/area/sector_b)
"al" = (/obj/structure/railing{icon_state = "corneroverlay"; dir = 1},/obj/structure/railing{icon_state = "frontoverlay_r"; dir = 1},/obj/structure/railing{icon_state = "railing1"; dir = 1},/obj/structure/railing{icon_state = "frontoverlay_l"; dir = 8},/obj/structure/railing{icon_state = "railing1"; dir = 8},/turf/simulated/open,/area/sector_b)
"am" = (/obj/structure/lattice,/obj/structure/railing{icon_state = "railing0"; dir = 1},/turf/simulated/open,/area/sector_b)
"an" = (/obj/structure/lattice,/turf/simulated/open,/area/sector_b)
"ao" = (/obj/structure/lattice,/obj/structure/railing{icon_state = "railing0"; dir = 4},/turf/simulated/open,/area/sector_b)
"ap" = (/obj/structure/railing{icon_state = "railing0"; dir = 8},/turf/simulated/open,/area/sector_b)
"aq" = (/obj/machinery/door/airlock/multi_tile/glass,/turf/simulated/floor/tiled/dark,/area/sector_b)
"ar" = (/turf/simulated/floor/wood,/area/sector_b)
"as" = (/obj/machinery/light{dir = 1},/turf/simulated/floor/wood,/area/sector_b)
"at" = (/obj/structure/railing{icon_state = "railing0"; dir = 4},/turf/simulated/open,/area/sector_b)
"au" = (/obj/machinery/light{icon_state = "tube1"; dir = 8},/turf/simulated/floor/tiled/dark,/area/sector_b)
"av" = (/obj/structure/railing{icon_state = "railing1"; dir = 8},/obj/structure/railing{icon_state = "corneroverlay"; dir = 8},/obj/structure/railing{icon_state = "railing1"},/obj/structure/railing{icon_state = "frontoverlay_l"},/obj/structure/railing{icon_state = "frontoverlay_r"; dir = 8},/turf/simulated/open,/area/sector_b)
"aw" = (/obj/machinery/door/firedoor/multi_tile,/obj/machinery/door/airlock/multi_tile/glass,/turf/simulated/floor/tiled/white,/area/sector_b)
"ax" = (/turf/simulated/floor/tiled/white,/area/sector_b)
"ay" = (/obj/machinery/door/blast/regular/open,/turf/simulated/floor/plating,/area/sector_b)
"az" = (/turf/simulated/floor/plating,/area/sector_b)
"aA" = (/obj/machinery/door/blast/regular,/turf/simulated/floor/plating,/area/sector_b)
"aB" = (/turf/simulated/floor/asteroid,/area/sector_b)
"aC" = (/obj/machinery/door/firedoor,/obj/machinery/door/airlock/glass_medical,/turf/simulated/floor/tiled/white,/area/sector_b)
"aD" = (/obj/machinery/door/firedoor/multi_tile{icon_state = "door_open"; dir = 2},/obj/machinery/door/blast/regular/open,/turf/simulated/floor/plating,/area/sector_b)
"aE" = (/obj/machinery/door/firedoor/multi_tile{icon_state = "door_open"; dir = 2},/obj/machinery/door/blast/regular,/turf/simulated/floor/plating,/area/sector_b)
"aF" = (/turf/simulated/floor/dirty,/area/sector_b)
"aG" = (/obj/machinery/light/spot{icon_state = "tube1"; dir = 4},/turf/simulated/floor/dirty,/area/sector_b)
"aH" = (/obj/machinery/light/spot{icon_state = "tube1"; dir = 4},/turf/simulated/floor/tiled/white,/area/sector_b)
"aI" = (/turf/simulated/floor/tiled/freezer,/area/sector_b)
"aJ" = (/obj/structure/railing{icon_state = "railing1"; dir = 1},/obj/structure/railing{icon_state = "railing1"; dir = 8},/obj/structure/railing{icon_state = "frontoverlay_r"; dir = 1},/obj/structure/railing{icon_state = "frontoverlay_l"; dir = 8},/obj/structure/railing{icon_state = "corneroverlay"; dir = 1},/turf/simulated/open,/area/sector_b)
"aK" = (/obj/structure/grille,/obj/structure/window/reinforced,/obj/structure/window/reinforced{icon_state = "rwindow"; dir = 1},/obj/structure/window/reinforced{icon_state = "rwindow"; dir = 8},/turf/simulated/floor,/area/sector_b)
"aL" = (/obj/structure/grille,/obj/structure/window/reinforced,/obj/structure/window/reinforced{icon_state = "rwindow"; dir = 1},/turf/simulated/floor,/area/sector_b)
"aM" = (/obj/structure/grille,/obj/structure/window/reinforced,/obj/structure/window/reinforced{icon_state = "rwindow"; dir = 4},/obj/structure/window/reinforced{icon_state = "rwindow"; dir = 1},/turf/simulated/floor,/area/sector_b)
"aN" = (/obj/machinery/light/spot{icon_state = "tube1"; dir = 8},/turf/simulated/floor/dirty,/area/sector_b)
"aO" = (/obj/machinery/light{icon_state = "tube1"; dir = 4},/turf/simulated/floor/tiled/white,/area/sector_b)
"aP" = (/obj/machinery/light/spot{icon_state = "tube1"; dir = 1},/turf/simulated/floor/tiled/freezer,/area/sector_b)
"aQ" = (/obj/machinery/light/spot{icon_state = "tube1"; dir = 8},/turf/simulated/floor/tiled/white,/area/sector_b)
"aR" = (/obj/structure/table/marble,/turf/simulated/floor/tiled/white,/area/sector_b)
"aS" = (/obj/structure/railing{icon_state = "railing1"; dir = 8},/obj/structure/railing{icon_state = "frontoverlay_r"; dir = 8},/obj/structure/railing{icon_state = "corneroverlay"; dir = 8},/obj/structure/railing{icon_state = "frontoverlay_l"},/obj/structure/railing{icon_state = "railing1"},/turf/simulated/open,/area/sector_b)
"aT" = (/obj/machinery/optable,/turf/simulated/floor/tiled/white,/area/sector_b)
"aU" = (/obj/machinery/door/firedoor,/obj/machinery/door/airlock/medical,/turf/simulated/floor/tiled/white,/area/sector_b)
"aV" = (/obj/machinery/light,/turf/simulated/floor/tiled/white,/area/sector_b)
"aW" = (/obj/machinery/door/firedoor/multi_tile{icon_state = "door_open"; dir = 1},/obj/machinery/door/airlock/multi_tile/glass{icon_state = "door_closed"; dir = 1},/turf/simulated/floor/tiled/white,/area/sector_b)
"aX" = (/obj/machinery/light/spot,/turf/simulated/floor/tiled/freezer,/area/sector_b)
"aY" = (/obj/machinery/door/firedoor/multi_tile,/obj/machinery/door/airlock/multi_tile/glass,/turf/simulated/floor/tiled/freezer,/area/sector_b)
"aZ" = (/obj/structure/railing{icon_state = "corneroverlay"; dir = 1},/obj/structure/railing{icon_state = "railing1"; dir = 1},/obj/structure/railing{icon_state = "frontoverlay_l"; dir = 8},/obj/structure/railing{icon_state = "frontoverlay_r"; dir = 1},/obj/structure/railing{icon_state = "railing1"; dir = 8},/turf/simulated/open,/area/sector_b)
"ba" = (/obj/machinery/cryopod{icon_state = "body_scanner_0"; dir = 2},/turf/simulated/floor/tiled/white,/area/sector_b)
"bb" = (/obj/machinery/light{icon_state = "tube1"; dir = 8},/turf/simulated/floor/tiled/freezer,/area/sector_b)
"bc" = (/obj/machinery/light{icon_state = "tube1"; dir = 4},/turf/simulated/floor/tiled/freezer,/area/sector_b)
"bd" = (/obj/machinery/power/apc/hyper{icon_state = "apc0"; dir = 1},/turf/simulated/floor/tiled/dark,/area/sector_b)
"be" = (/obj/machinery/computer/cryopod,/turf/simulated/wall/r_wall,/area/sector_b)
"bf" = (/obj/structure/railing{icon_state = "corneroverlay"; dir = 8},/obj/structure/railing{icon_state = "railing1"; dir = 8},/obj/structure/railing{icon_state = "frontoverlay_r"; dir = 8},/obj/structure/railing{icon_state = "railing1"},/obj/structure/railing{icon_state = "frontoverlay_l"},/turf/simulated/open,/area/sector_b)
"bg" = (/obj/structure/lattice,/obj/structure/railing,/turf/simulated/open,/area/sector_b)
"bh" = (/obj/machinery/light/spot{icon_state = "tube1"; dir = 4},/turf/simulated/floor/tiled/dark,/area/sector_b)
"bi" = (/obj/structure/railing{icon_state = "mcorneroverlay"; dir = 4},/turf/simulated/open,/area/sector_b)
"bj" = (/obj/machinery/light/spot,/turf/simulated/floor/tiled/dark,/area/sector_b)
"bk" = (/obj/turbolift_map_holder{icon_state = ""; dir = 8},/turf/simulated/floor/plating,/area/sector_b)

(1,1,1) = {"
aaaaaaaaaaaaaaaaaaaaaaaaaaaaaaaaaaaaaaaaaaaaaaaaaaaaaaaaaaaaaaaaaaaaaaaaaaaaaaaaaaaaaaaaaaaaaaaaaaaaaaaaaaaaaaaaaaaaaaaaaaaaaaaaaaaaaaaaaaaaaaaaaaaaaaaaaaaaaaaaaaaaaaaaaaaaaaaaaaaaaaaaaaaaaaaaaaaaaaaa
aaaaaaaaaaaaaaaaaaaaaaaaaaaaaaaaaaaaaaaaaaaaaaaaaaaaaaaaaaaaaaaaaaaaaaaaaaaaaaaaaaaaaaaaaaaaaaaaaaaaaaaaaaaaaaaaaaaaaaaaaaaaaaaaaaaaaaaaaaaaaaaaaaaaaaaaaaaaaaaaaaaaaaaaaaaaaaaaaaaaaaaaaaaaaaaaaaaaaaaa
aaaaaaaaaaaaaaaaaaaaaaaaaaaaaaaaaaaaaaaaaaaaaaaaaaaaaaaaaaaaaaaaaaaaaaaaaaaaaaaaaaaaaaaaaaaaaaaaaaaaaaaaaaaaaaaaaaaaaaaaaaaaaaaaaaaaaaaaaaaaaaaaaaaaaaaaaaaaaaaaaaaaaaaaaaaaaaaaaaaaaaaaaaaaaaaaaaaaaaaa
aaaaaaaaaaaaaaaaaaaaaaaaaaaaaaaaaaaaaaaaaaaaaaaaaaaaaaaaaaaaaaaaaaaaaaaaaaaaaaaaaaaaaaaaaaaaaaaaaaaaaaaaaaaaaaaaaaaaaaaaaaaaaaaaaaaaaaaaaaaaaaaaaaaaaaaaaaaaaaaaaaaaaaaaaaaaaaaaaaaaaaaaaaaaaaaaaaaaaaaa
aaaaaaaaaaaaaaaaaaaaaaaaaaaaaaaaaaaaaaaaaaaaaaaaaaaaaaaaaaaaaaaaaaaaaaaaaaaaaaaaaaaaaaaaaaaaaaaaaaaaaaaaaaaaaaaaaaaaaaaaaaaaaaaaaaaaaaaaaaaaaaaaaaaaaaaaaaaaaaaaaaaaaaaaaaaaaaaaaaaaaaaaaaaaaaaaaaaaaaaa
aaaaaaaaaaaaaaaaaaaaaaaaaaaaaaaaaaaaaaaaaaaaaaaaaaaaaaaaaaaaaaaaaaaaaaaaaaaaaaaaaaaaaaaaaaaaaaaaaaaaaaaaaaaaaaaaaaaaaaaaaaaaaaaaaaaaaaaaaaaaaaaaaaaaaaaaaaaaaaaaaaaaaaaaaaaaaaaaaaaaaaaaaaaaaaaaaaaaaaaa
aaaaaaaaaaaaaaaaaaaaaaaaaaaaaaaaaaaaaaaaaaaaaaaaaaaaaaaaaaaaaaaaaaaaaaaaaaaaaaaaaaaaaaaaaaaaaaaaaaaaaaaaaaaaaaaaaaaaaaaaaaaaaaaaaaaaaaaaaaaaaaaaaaaaaaaaaaaaaaaaaaaaaaaaaaaaaaaaaaaaaaaaaaaaaaaaaaaaaaaa
aaaaaaaaaaaaaaaaaaaaaaaaaaaaaaaaaaaaaaaaaaaaaaaaaaaaaaaaaaaaaaaaaaaaaaaaaaaaaaaaaaaaaaaaaaaaaaaaaaaaaaaaaaaaaaaaaaaaaaaaaaaaaaaaaaaaaaaaaaaaaaaaaaaaaaaaaaaaaaaaaaaaaaaaaaaaaaaaaaaaaaaaaaaaaaaaaaaaaaaa
aaaaaaaaaaaaaaaaaaaaaaaaaaaaaaaaaaaaaaaaaaaaaaaaaaaaaaaaaaaaaaaaaaaaaaaaaaaaaaaaaaaaaaaaaaaaaaaaaaaaaaaaaaaaaaaaaaaaaaaaaaaaaaaaaaaaaaaaaaaaaaaaaaaaaaaaaaaaaaaaaaaaaaaaaaaaaaaaaaaaaaaaaaaaaaaaaaaaaaaa
aaaaaaaaaaaaaaaaaaaaaaaaaaadadadadadadadaaaaaaaaaaaaaaaaaaaaaaaaaaaaaaaaaaaaaaaaaaaaaaaaaaaaaaaaaaaaaaaaaaaaaaaaaaaaaaaaaaaaaaaaaaaaaaaaaaaaaaaaaaaaaaaaaaaaaaaaaaaaaaaaaaaaaaaaaaaaaaaaaaaaaaaaaaaaaaaa
aaaaaaaaaaaaaaaaaaadadadadadazazazazazadaaaaaaaaaaaaaaaaaaaaaaaaaaaaaaaaaaaaaaaaaaaaaaaaaaaaaaaaaaaaaaaaaaaaaaaaaaaaaaaaaaaaaaaaaaaaaaaaaaaaaaaaaaaaaaaaaaaaaaaaaaaaaaaaaaaaaaaaaaaaaaaaaaaaaaaaaaaaaaaa
aaaaaaaaaaaaaaaaaaadaeaeaeaeazazazazazadaaaaaaaaaaaaaaaaaaaaaaaaaaaaaaaaaaaaaaaaaaaaaaaaaaaaaaaaaaaaaaaaaaaaaaaaaaaaaaaaaaaaaaaaaaaaaaaaaaaaaaaaaaaaaaaaaaaaaaaaaaaaaaaaaaaaaaaaaaaaaaaaaaaaaaaaaaaaaaaa
aaaaaaaaaaaaaaaaaaadaeaeaeaeazazazazazadaaaaaaaaaaaaaaaaaaaaaaaaaaaaaaaaaaaaaaaaaaaaaaaaaaaaaaaaaaaaaaaaaaaaaaaaaaaaaaaaaaaaaaaaaaaaaaaaaaaaaaaaaaaaaaaaaaaaaaaaaaaaaaaaaaaaaaaaaaaaaaaaaaaaaaaaaaaaaaaa
aaaaaaaaaaaaaaaaaaadaeaeaeaeazazazazazadaaaaaaaaaaaaaaaaaaaaaaaaaaaaaaaaaaaaaaaaaaaaaaaaaaaaaaaaaaaaaaaaaaaaaaaaaaaaaaaaaaaaaaaaaaaaaaaaaaaaaaaaaaaaaaaaaaaaaaaaaaaaaaaaaaaaaaaaaaaaaaaaaaaaaaaaaaaaaaaa
aaaaaaaaaaaaaaaaaaadaeaeaeadbkazazazazadaaaaaaaaaaaaaaaaaaaaaaaaaaaaaaaaaaaaaaaaaaaaaaaaaaaaaaaaaaaaaaaaaaaaaaaaaaaaaaaaaaaaaaaaaaaaaaaaaaaaaaaaaaaaaaaaaaaaaaaaaaaaaaaaaaaaaaaaaaaaaaaaaaaaaaaaaaaaaaaa
aaaaaaaaaaaaaaaaaaadaeaeaeadadadadadadadaaaaaaaaaaaaaaaaaaaaaaaaaaaaaaaaaaaaaaaaaaaaaaaaaaaaaaaaaaaaaaaaaaaaaaaaaaaaaaaaaaaaaaaaaaaaaaaaaaaaaaaaaaaaaaaaaaaaaaaaaaaaaaaaaaaaaaaaaaaaaaaaaaaaaaaaaaaaaaaa
aaaaaaaaaaaaaaaaaaadaeaeaeaeaaaaaaaaaaaaaaaaaaaaaaaaaaaaaaaaaaaaaaaaaaaaaaaaaaaaaaaaaaaaaaaaaaaaaaaaaaaaaaaaaaaaaaaaaaaaaaaaaaaaaaaaaaaaaaaaaaaaaaaaaaaaaaaaaaaaaaaaaaaaaaaaaaaaaaaaaaaaaaaaaaaaaaaaaaaa
aaaaaaaaaaaaaaaaaaadaeaeaeaeaaaaaaaaaaaaaaaaaaaaaaaaaaaaaaaaaaaaaaaaaaaaaaaaaaaaaaaaaaaaaaaaaaaaaaaaaaaaaaaaaaaaaaaaaaaaaaaaaaaaaaaaaaaaaaaaaaaaaaaaaaaaaaaaaaaaaaaaaaaaaaaaaaaaaaaaaaaaaaaaaaaaaaaaaaaa
aaaaaaaaaaaaaaaaaaadaeaeaeaeaaaaaaaaaaaaaaaaaaaaaaaaaaaaaaaaaaaaaaaaaaaaaaaaaaaaaaaaaaaaaaaaaaaaaaaaaaaaaaaaaaaaaaaaaaaaaaaaaaaaaaaaaaaaaaaaaaaaaaaaaaaaaaaaaaaaaaaaaaaaaaaaaaaaaaaaaaaaaaaaaaaaaaaaaaaa
aaaaaaaaaaaaaaaaaaadadadadadaaaaaaaaaaaaaaaaaaaaaaaaaaaaaaaaaaaaaaaaaaaaaaaaaaaaaaaaaaaaaaaaaaaaaaaaaaaaaaaaaaaaaaaaaaaaaaaaaaaaaaaaaaaaaaaaaaaaaaaaaaaaaaaaaaaaaaaaaaaaaaaaaaaaaaaaaaaaaaaaaaaaaaaaaaaa
aaaaaaaaaaaaaaaaaaaaaaaaaaaaaaaaaaaaaaaaaaaaaaaaaaaaaaaaaaaaaaaaaaaaaaaaaaaaaaaaaaaaaaaaaaaaaaaaaaaaaaaaaaaaaaaaaaaaaaaaaaaaaaaaaaaaaaaaaaaaaaaaaaaaaaaaaaaaaaaaaaaaaaaaaaaaaaaaaaaaaaaaaaaaaaaaaaaaaaaa
aaaaaaaaaaaaaaaaaaaaaaaaaaaaaaaaaaaaaaaaaaaaaaaaaaaaaaaaaaaaaaaaaaaaaaaaaaaaaaaaaaaaaaaaaaaaaaaaaaaaaaaaaaaaaaaaaaaaaaaaaaaaaaaaaaaaaaaaaaaaaaaaaaaaaaaaaaaaaaaaaaaaaaaaaaaaaaaaaaaaaaaaaaaaaaaaaaaaaaaa
aaaaaaaaaaaaaaaaaaaaaaaaaaaaaaaaaaaaaaaaaaaaaaaaaaaaaaaaaaaaaaaaaaaaaaaaaaaaaaaaaaaaaaaaaaaaaaaaaaaaaaaaaaaaaaaaaaaaaaaaaaaaaaaaaaaaaaaaaaaaaaaaaaaaaaaaaaaaaaaaaaaaaaaaaaaaaaaaaaaaaaaaaaaaaaaaaaaaaaaa
aaaaaaaaaaaaaaaaaaaaaaaaaaaaaaaaaaaaaaaaaaaaaaaaaaaaaaaaaaaaaaaaaaaaaaaaaaaaaaaaaaaaaaaaaaaaaaaaaaaaaaaaaaaaaaaaaaaaaaaaaaaaaaaaaaaaaaaaaaaaaaaaaaaaaaaaaaaaaaaaaaaaaaaaaaaaaaaaaaaaaaaaaaaaaaaaaaaaaaaa
aaaaaaaaaaaaaaaaaaaaaaaaaaaaaaaaaaaaaaaaaaaaaaaaaaaaaaaaaaaaaaaaaaaaaaaaaaaaaaaaaaaaaaaaaaaaaaaaaaaaaaaaaaaaaaaaaaaaaaaaaaaaaaaaaaaaaaaaaaaaaaaaaaaaaaaaaaaaaaaaaaaaaaaaaaaaaaaaaaaaaaaaaaaaaaaaaaaaaaaa
aaaaaaaaaaaaaaaaaaaaaaaaaaaaaaaaaaaaaaaaaaaaaaaaaaaaaaaaaaaaaaaaaaaaaaaaaaaaaaaaaaaaaaaaaaaaaaaaaaaaaaaaaaaaaaaaaaaaaaaaaaaaaaaaaaaaaaaaaaaaaaaaaaaaaaaaaaaaaaaaaaaaaaaaaaaaaaaaaaaaaaaaaaaaaaaaaaaaaaaa
aaaaaaaaaaaaaaaaaaaaaaaaaaaaaaaaaaaaaaaaaaaaaaaaaaaaaaaaaaaaaaaaaaaaaaaaaaaaaaaaaaaaaaaaaaaaaaaaaaaaaaaaaaaaaaaaaaaaaaaaaaaaaaaaaaaaaaaaaaaaaaaaaaaaaaaaaaaaaaaaaaaaaaaaaaaaaaaaaaaaaaaaaaaaaaaaaaaaaaaa
aaaaaaaaaaaaaaaaaaaaaaaaaaaaaaaaaaaaaaaaaaaaaaaaaaaaaaaaaaaaaaaaaaaaaaaaaaaaaaaaaaaaaaaaaaaaaaaaaaaaaaaaaaaaaaaaaaaaaaaaaaaaaaaaaaaaaaaaaaaaaaaaaaaaaaaaaaaaaaaaaaaaaaaaaaaaaaaaaaaaaaaaaaaaaaaaaaaaaaaa
aaaaaaaaaaaaaaaaaaaaaaaaaaaaaaaaaaaaaaaaaaaaaaaaaaaaaaaaaaaaaaaaaaaaaaaaaaaaaaaaaaaaaaaaaaaaaaaaaaaaaaaaaaaaaaaaaaaaaaaaaaaaaaaaaaaaaaaaaaaaaaaaaaaaaaaaaaaaaaaaaaaaaaaaaaaaaaaaaaaaaaaaaaaaaaaaaaaaaaaa
aaaaaaaaaaaaaaaaaaaaaaaaaaaaaaaaaaaaaaaaaaaaaaaaaaaaaaaaaaaaaaaaaaaaaaaaaaaaaaaaaaaaaaaaaaaaaaaaaaaaaaaaaaaaaaaaaaaaaaaaaaaaaaaaaaaaaaaaaaaaaaaaaaaaaaaaaaaaaaaaaaaaaaaaaaaaaaaaaaaaaaaaaaaaaaaaaaaaaaaa
aaaaaaaaaaaaaaaaaaaaaaaaaaaaaaaaaaaaaaaaaaaaaaaaaaaaaaaaaaaaaaaaaaaaaaaaaaaaaaaaaaaaaaaaaaaaaaaaaaaaaaaaaaaaaaaaaaaaaaaaaaaaaaaaaaaaaaaaaaaaaaaaaaaaaaaaaaaaaaaaaaaaaaaaaaaaaaaaaaaaaaaaaaaaaaaaaaaaaaaa
aaaaaaaaaaaaaaaaaaaaaaaaaaaaaaaaaaaaaaaaaaaaaaaaaaaaaaaaaaaaaaaaaaaaaaaaaaaaaaaaaaaaaaaaaaaaaaaaaaaaaaaaaaaaaaaaaaaaaaaaaaaaaaaaaaaaaaaaaaaaaaaaaaaaaaaaaaaaaaaaaaaaaaaaaaaaaaaaaaaaaaaaaaaaaaaaaaaaaaaa
aaaaaaaaaaaaaaaaaaaaaaaaaaaaaaaaaaaaaaaaaaaaaaaaaaaaaaaaaaaaaaaaaaaaaaaaaaaaaaaaaaaaaaaaaaaaaaaaaaaaaaaaaaaaaaaaaaaaaaaaaaaaaaaaaaaaaaaaaaaaaaaaaaaaaaaaaaaaaaaaaaaaaaaaaaaaaaaaaaaaaaaaaaaaaaaaaaaaaaaa
aaaaaaaaaaaaaaaaaaaaaaaaaaaaaaaaaaaaaaaaaaaaaaaaaaaaaaaaaaaaaaaaaaaaaaaaaaaaaaaaaaaaaaaaaaaaaaaaaaaaaaaaaaaaaaaaaaaaaaaaaaaaaaaaaaaaaaaaaaaaaaaaaaaaaaaaaaaaaaaaaaaaaaaaaaaaaaaaaaaaaaaaaaaaaaaaaaaaaaaa
aaaaaaaaaaaaaaaaaaaaaaaaaaaaaaaaaaaaaaaaaaaaaaaaaaaaaaaaaaaaaaaaaaaaaaaaaaaaaaaaaaaaaaaaaaaaaaaaaaaaaaaaaaaaaaaaaaaaaaaaaaaaaaaaaaaaaaaaaaaaaaaaaaaaaaaaaaaaaaaaaaaaaaaaaaaaaaaaaaaaaaaaaaaaaaaaaaaaaaaa
aaaaaaaaaaaaaaaaaaaaaaaaaaaaaaaaaaaaaaaaaaaaaaaaaaaaaaaaaaaaaaaaaaaaaaaaaaaaaaaaaaaaaaaaaaaaaaaaaaaaaaaaaaaaaaaaaaaaaaaaaaaaaaaaaaaaaaaaaaaaaaaaaaaaaaaaaaaaaaaaaaaaaaaaaaaaaaaaaaaaaaaaaaaaaaaaaaaaaaaa
aaaaaaaaaaaaaaaaaaaaaaaaaaaaaaaaaaaaaaaaaaaaaaaaaaaaaaaaaaaaaaaaaaaaaaaaaaaaaaaaaaaaaaaaaaaaaaaaaaaaaaaaaaaaaaaaaaaaaaaaaaaaaaaaaaaaaaaaaaaaaaaaaaaaaaaaaaaaaaaaaaaaaaaaaaaaaaaaaaaaaaaaaaaaaaaaaaaaaaaa
aaaaaaaaaaaaaaaaaaaaaaaaaaaaaaaaaaaaaaaaaaaaaaaaaaaaaaaaaaaaaaaaaaaaaaaaaaaaaaaaaaaaaaaaaaaaaaaaaaaaaaaaaaaaaaaaaaaaaaaaaaaaaaaaaaaaaaaaaaaaaaaaaaaaaaaaaaaaaaaaaaaaaaaaaaaaaaaaaaaaaaaaaaaaaaaaaaaaaaaa
aaaaaaaaaaaaaaaaaaaaaaaaaaaaaaaaaaaaaaaaaaaaaaaaaaaaaaaaaaaaaaaaaaaaaaaaaaaaaaaaaaaaaaaaaaaaaaaaaaaaaaaaaaaaaaaaaaaaaaaaaaaaaaaaaaaaaaaaaaaaaaaaaaaaaaaaaaaaaaaaaaaaaaaaaaaaaaaaaaaaaaaaaaaaaaaaaaaaaaaa
aaaaaaaaaaaaaaaaaaaaaaaaaaaaaaaaaaaaaaaaaaaaaaaaaaaaaaaaaaaaaaaaaaaaaaaaaaaaaaaaaaaaaaaaaaaaaaaaaaaaaaaaaaaaaaaaaaaaaaaaaaaaaaaaaaaaaaaaaaaaaaaaaaaaaaaaaaaaaaaaaaaaaaaaaaaaaaaaaaaaaaaaaaaaaaaaaaaaaaaa
aaaaaaaaaaaaaaaaaaaaaaaaaaaaaaaaaaaaaaaaaaaaaaaaaaaaaaaaaaaaaaaaaaaaaaaaaaaaaaaaaaaaaaaaaaaaaaaaaaaaaaaaaaaaaaaaaaaaaaaaaaaaaaaaaaaaaaaaaaaaaaaaaaaaaaaaaaaaaaaaaaaaaaaaaaaaaaaaaaaaaaaaaaaaaaaaaaaaaaaa
aaaaaaaaaaaaaaaaaaaaaaaaaaaaaaaaaaaaaaaaaaaaaaaaaaaaaaaaaaaaaaaaaaaaaaaaaaaaaaaaaaaaaaaaaaaaaaaaaaaaaaaaaaaaaaaaaaaaaaaaaaaaaaaaaaaaaaaaaaaaaaaaaaaaaaaaaaaaaaaaaaaaaaaaaaaaaaaaaaaaaaaaaaaaaaaaaaaaaaaa
aaaaaaaaaaaaaaaaaaaaaaaaaaaaaaaaaaaaaaaaaaaaaaaaaaaaaaaaaaaaaaaaaaaaaaaaaaaaaaaaaaaaaaaaaaaaaaaaaaaaaaaaaaaaaaaaaaaaaaaaaaaaaaaaaaaaaaaaaaaaaaaaaaaaaaaaaaaaaaaaaaaaaaaaaaaaaaaaaaaaaaaaaaaaaaaaaaaaaaaa
aaaaaaaaaaaaaaaaaaaaaaaaaaaaaaaaaaaaaaaaaaaaaaaaaaaaaaaaaaaaaaaaaaaaaaaaaaaaaaaaaaaaaaaaaaaaaaaaaaaaaaaaaaaaaaaaaaaaaaaaaaaaaaaaaaaaaaaaaaaaaaaaaaaaaaaaaaaaaaaaaaaaaaaaaaaaaaaaaaaaaaaaaaaaaaaaaaaaaaaa
aaaaaaaaaaaaaaaaaaaaaaaaaaaaaaaaaaaaaaaaaaaaaaaaaaaaaaaaaaaaaaaaaaaaaaaaaaaaaaaaaaaaaaaaaaaaaaaaaaaaaaaaaaaaaaaaaaaaaaaaaaaaaaaaaaaaaaaaaaaaaaaaaaaaaaaaaaaaaaaaaaaaaaaaaaaaaaaaaaaaaaaaaaaaaaaaaaaaaaaa
aaaaaaaaaaaaaaaaaaaaaaaaaaaaaaaaaaaaaaaaaaaaaaaaaaaaaaaaaaaaaaaaaaaaaaaaaaaaaaaaaaaaaaaaaaaaaaaaaaaaaaaaaaaaaaaaaaaaaaaaaaaaaaaaaaaaaaaaaaaaaaaaaaaaaaaaaaaaaaaaaaaaaaaaaaaaaaaaaaaaaaaaaaaaaaaaaaaaaaaa
aaaaaaaaaaaaaaaaaaaaaaaaaaaaaaaaaaaaaaaaaaaaaaaaaaaaaaaaaaaaaaaaaaaaaaaaaaaaaaaaaaaaaaaaaaaaaaaaaaaaaaaaaaaaaaaaaaaaaaaaaaaaaaaaaaaaaaaaaaaaaaaaaaaaaaaaaaaaaaaaaaaaaaaaaaaaaaaaaaaaaaaaaaaaaaaaaaaaaaaa
aaaaaaaaaaaaaaaaaaaaaaaaaaaaaaaaaaaaaaaaaaaaaaaaaaaaaaaaaaaaaaaaaaaaaaaaaaaaaaaaaaaaaaaaaaaaaaaaaaaaaaaaaaaaaaaaaaaaaaaaaaaaaaaaaaaaaaaaaaaaaaaaaaaaaaaaaaaaaaaaaaaaaaaaaaaaaaaaaaaaaaaaaaaaaaaaaaaaaaaa
aaaaaaaaaaaaaaaaaaaaaaaaaaaaaaaaaaaaaaaaaaaaaaaaaaaaaaaaaaaaaaaaaaaaaaaaaaaaaaaaaaaaaaaaaaaaaaaaaaaaaaaaaaaaaaaaaaaaaaaaaaaaaaaaaaaaaaaaaaaaaaaaaaaaaaaaaaaaaaaaaaaaaaaaaaaaaaaaaaaaaaaaaaaaaaaaaaaaaaaa
aaaaaaaaaaaaaaaaaaaaaaaaaaaaaaaaaaaaaaaaaaaaaaaaaaaaaaaaaaaaaaaaaaaaaaaaaaaaaaaaaaaaaaaaaaaaaaaaaaaaaaaaaaaaaaaaaaaaaaaaaaaaaaaaaaaaaaaaaaaaaaaaaaaaaaaaaaaaaaaaaaaaaaaaaaaaaaaaaaaaaaaaaaaaaaaaaaaaaaaa
aaaaaaaaaaaaaaaaaaaaaaaaaaaaaaaaaaaaaaaaaaaaaaaaaaaaaaaaaaaaaaaaaaaaaaaaaaaaaaaaaaaaaaaaaaaaaaaaaaaaaaaaaaaaaaaaaaaaaaaaaaaaaaaaaaaaaaaaaaaaaaaaaaaaaaaaaaaaaaaaaaaaaaaaaaaaaaaaaaaaaaaaaaaaaaaaaaaaaaaa
aaaaaaaaaaaaaaaaaaaaaaaaaaaaaaaaaaaaaaaaaaaaaaaaaaaaaaaaaaaaaaaaaaaaaaaaaaaaaaaaaaaaaaaaaaaaaaaaaaaaaaaaaaaaaaaaaaaaaaaaaaaaaaaaaaaaaaaaaaaaaaaaaaaaaaaaaaaaaaaaaaaaaaaaaaaaaaaaaaaaaaaaaaaaaaaaaaaaaaaa
aaaaaaaaaaaaaaaaaaaaaaaaaaaaaaaaaaaaaaaaaaaaaaaaaaaaaaaaaaaaaaaaaaaaaaaaaaaaaaaaaaaaaaaaaaaaaaaaaaaaaaaaaaaaaaaaaaaaaaaaaaaaaaaaaaaaaaaaaaaaaaaaaaaaaaaaaaaaaaaaaaaaaaaaaaaaaaaaaaaaaaaaaaaaaaaaaaaaaaaa
aaaaaaaaaaaaaaaaaaaaaaaaaaaaaaaaaaaaaaaaaaaaaaaaaaaaaaaaaaaaaaaaaaaaaaaaaaaaaaaaaaaaaaaaaaaaaaaaaaaaaaaaaaaaaaaaaaaaaaaaaaaaaaaaaaaaaaaaaaaaaaaaaaaaaaaaaaaaaaaaaaaaaaaaaaaaaaaaaaaaaaaaaaaaaaaaaaaaaaaa
ababababababaaaaaaaaaaaaaaaaaaaaaaaaaaaaaaaaaaaaaaaaaaaaaaaaaaaaaaaaaaaaaaaaaaaaaaaaaaaaaaaaaaaaaaaaaaaaaaaaaaaaaaaaaaaaaaaaaaaaaaaaaaaaaaaaaaaaaaaaaaaaaaaaaaaaaaaaaaaaaaaaaaaaaaaaaaaaaaaaaaaaaaaaaaaa
abababababaaaaaaaaaaaaaaaaaaaaaaaaaaaaaaaaaaaaaaaaaaaaaaaaaaaaaaaaaaaaaaaaaaaaaaaaaaaaaaaaaaaaaaaaaaaaaaaaaaaaaaaaaaaaaaaaaaaaaaaaaaaaaaaaaaaaaaaaaaaaaaaaaaaaaaaaaaaaaaaaaaaaaaaaaaaaaaaaaaaaaaaaaaaaaa
abababababaaaaaaaaaaaaaaaaaaaaaaaaaaaaaaaaaaaaaaaaaaaaaaaaaaaaaaaaaaaaaaaaaaaaaaaaaaaaaaaaaaaaaaaaaaaaaaaaaaaaaaaaaaaaaaaaaaaaaaaaaaaaaaaaaaaaaaaaaaaaaaaaaaaaaaaaaaaaaaaaaaaaaaaaaaaaaaaaaaaaaaaaaaaaaa
abababababaaaaaaaaaaaaaaaaaaaaaaaaaaaaaaaaaaaaaaaaaaaaaaaaaaaaaaaaaaaaaaaaaaaaaaaaaaaaaaaaaaaaaaaaaaaaaaaaaaaaaaaaaaaaaaaaaaaaaaaaaaaaaaaaaaaaaaaaaaaaaaaaaaaaaaaaaaaaaaaaaaaaaaaaaaaaaaaaaaaaaaaaaaaaaa
ababababaaaaaaaaaaaaaaaaaaaaaaaaaaaaaaaaaaaaaaaaaaaaaaaaaaaaaaaaaaaaaaaaaaaaaaaaaaaaaaaaaaaaaaaaaaaaaaaaaaaaaaaaaaaaaaaaaaaaaaaaaaaaaaaaaaaaaaaaaaaaaaaaaaaaaaaaaaaaaaaaaaaaaaaaaaaaaaaaaaaaaaaaaaaaaaaa
ababababaaacacacaaaaaaaaaaaaaaaaaaaaaaaaaaaaaaaaaaaaaaaaaaaaaaaaaaaaaaaaaaaaaaaaaaaaaaaaaaaaaaaaaaaaaaaaaaaaaaaaaaaaaaaaaaaaaaaaaaaaaaaaaaaaaaaaaaaaaaaaaaaaaaaaaaaaaaaaaaaaaaaaaaaaaaaaaaaaaaaaaaaaaaaa
ababababaaacacacaaaaaaaaaaaaaaaaaaaaaaaaaaaaaaaaaaaaaaaaaaaaaaaaaaaaaaaaaaaaaaaaaaaaaaaaaaaaaaaaaaaaaaaaaaaaaaaaaaaaaaaaaaaaaaaaaaaaaaaaaaaaaaaaaaaaaaaaaaaaaaaaaaaaaaaaaaaaaaaaaaaaaaaaaaaaaaaaaaaaaaaa
abababaaaaacacacaaaaaaaaaaaaaaaaaaaaaaaaaaaaaaaaaaaaaaaaaaaaaaaaaaaaaaaaaaaaaaaaaaaaaaaaaaaaaaaaaaaaaaaaaaaaaaaaaaaaaaaaaaaaaaaaaaaaaaaaaaaaaaaaadadadadadadadadadadadadadadadadadadaaaaaaaaaaaaaaaaaaaa
abababaaaaacacacaaaaaaaaaaaaaaaaaaaaaaaaaaaaaaaaaaaaaaaaaaaaaaaaaaaaaaaaaaaaaaaaaaaaaaaaaaaaaaaaaaaaaaaaaaaaaaaaaaaaaaaaaaaaaaaaaaaaaaaaaaaaaaaaadababababababababababababababababadaaaaaaaaaaaaaaaaaaaa
abababaaaaacacacaaaaaaaaaaaaaaaaaaaaaaaaaaaaaaaaaaaaaaaaaaaaaaaaaaaaaaaaaaaaaaaaaaaaaaaaaaaaaaaaaaaaaaaaaaaaaaaaaaaaaaaaaaaaaaaaaaaaadadadadadadadababababababababababababababababadaaaaaaaaaaaaaaaaaaaa
abababaaaaacacacaaaaaaaaaaaaaaaaaaaaaaaaaaaaaaaaaaaaaaaaaaaaaaaaaaaaaaaaaaaaaaaaaaaaaaaaaaaaaaaaaaaaaaaaaaaaaaaaaaaaaaaaaaaaaaaaaaaaadaeaeaeaeaeadababadadadadadadadadadadadadababadaaaaaaaaaaaaaaaaaaaa
abababaaaaacacacaaaaaaaaaaaaaaaaaaaaaaaaaaaaaaaaaaaaaaaaaaaaaaaaaaaaaaaaaaaaaaaaaaaaaaaaaaaaaaaaaaaaaaaaaaaaaaaaaaaaaaaaaaaaaaaaaaadadaeaeaeaeaeadadadadaeaeaeaeaeaeaeaeaeaeadadadadaaaaaaaaaaadaaaaaaaa
ababababaaacacacaaafafafafafafafafafafafafafafafafafafafafafafafafafafafafafafafafafafafafafafafafafafafafafafafafafafafafafafafafadagaeaeaeaeaeaeahaeaeaeaeaeaeaeaeaeaeaeaeaeaeahaeaeaeaeaeaeadabababab
ababababaaacacacacacacacacacacacacacacacacacacacacacacacacacacacacacacacacacacacacacacacacacacacacacacacacacacacacacacacacacacacacaeaeaeaeaeaeaeaeaeaeaeaeaeaeaeaeaeaeaeaeaeaeaeaeaeaeaeaeaeaeadabababab
abababababacacacacacacacacacacacacacacacacacacacacacacacacacacacacacacacacacacacacacacacacacacacacacacacacacacacacacacacacacacacacaeaeaeaeaeaeaeaeaeaeaeaeaeaeaeaeaeaeaeaeaeaeaeaeaeaeaeaeaeaeadabababab
abababababacacacacacacacacacacacacacacacacacacacacacacacacacacacacacacacacacacacacacacacacacacacacacacacacacacacacacacacacacacacacaeaeaeaeaeaeaeaeaeaeaeaeaiaeaeaeaeaeaeaiaeaeaeaeaeaeaeaeaeaeadabababab
abababababacacacaaajajajajajajajajajajajajakacacacalajajamajajajajajajajajajajajajajajamajajajajajajajajajajajajajajajajajajajajajadagaeaeaeaeaeaeaeaeaeadadadadadadadadadadaeaeaeaeaeaeaeaeaeadabababab
abababadadadaaadadadadadadadadananananananaoacacacapaaaaanaaaaaaaaaaaaaaaaaaaaaaaaaaaaanaaaaaaaaaaaaaaaaaaaaaaaaaaaaaaaaaaaaaaaaaaadadaeaeaeaeaeadaqaeadadarasararararasaradadaqaeadaeaeaeaeaeadabababab
abababadaaaaaaaaaaaaaaaaaaaaadaaaaaaaaaaaaatacacacapaaaaanaaaaaaaaaaaaaaaaaaaaaaaaaaaaanaaaaaaaaaaaaaaaaaaaaaaaaaaaaaaaaaaaaaaaaaaaaadaeaeaeaeaeadararasararararararararararasararadauaeaeaeaeadabababab
abababadaaaaaaaaaaaaaaaaaaaaadaaaaaaaaaaaaatacacacapaaaaanaaaaaaaaaaaaaaaaaaaaaaaaaaaaanaaaaaaaaaaaaaaaaaaaaaaaaaaaaaaaaaaaaaaaaaaaaadaeaeaeaeaeadararararararararararararararararadaeaeaeaeaeadabababab
abababadaaaaaaaaaaaaaaaaaaaaadaaaaaaaaaaaaatacacacavafafadadadadadadadadadadadadadadadadanananananadadadadadadadadadadadadadadadadadadawaxadawaxadararararararararararararararararadaeaeaeaeaeadabababab
abababadaaaaaaaaaaaaaaaaaaaaadaaaaaaaaaaaaatacacacacacacayazazazaAaBaBaBaBaBaBaBaBaBaBadaaaaaaaaaaadaxaxaxaxaCaxaxaxaxaxaxaxaxaxaxaxadaxaxaxaxaxadararararadadadadadadadadararararadaeaeaeaeaeadabababab
abababadaaaaaaaaaaaaaaaaaaaaadaaaaaaaaaaaaatacacacacacacaDazazazaEaBaBaFaFaFaFaFaFaFaGadaaaaaaaaaaadaxaxaxaxadaxaxaxaxaxaxaxaxaxaxaHadaxaxaxaxaxadadadadadadaIaIaIaIaIaIadadadadadadaeaeaeaeaeadabababab
abababadadadadadadadadadadadadananananananaoacacacaJajajadaKaLaMadaNaBaFaFaFaFaFaFaFaFadaaaaaaaaaaadaxaxaxaOadaxaxaxaxaxaxaxaxaxaxaxadaxaxaxaxaOadaIaIaIaIaPaIaIaIaIaIaIaPaIaIaIaIadaeaeaeaeaeadabababab
ababababababababababababaaaaanaaaaaaaaaaaaatacacacapaaaaadaFaFaFaFaFaBaBaBaBaBaBaBaBaBadaaaaaaaaaaadaxaxaxaxadaxaxaxaxaxaxaxaxaxaxaxadaxaxaxaxaxadaIaIaIaIaIaIaIaIaIaIaIaIaIaIaIaIadauaeaeaeaeadabababab
ababababababababababaaaaaaaaanaaaaaaaaaaaaatacacacapaaaaadaFaFaFaFaFaBaFaFaFaFaFaFaFaFadaaaaaaaaaaadaxaxaxaxadaxaxaxaxaxaxaxaxaxaxaxadaxaxaxaxaxadaIaIaIaIaIaIaIaIaIaIaIaIaIaIaIaIadaeaeaeaeaeadabababab
ababababababababaaaaaaaaaaaaanaaaaaaaaaaaaatacacacapaaaaadaFaFaFaFaFaBaFaFaFaFaFaFaFaFadaaaaaaaaaaadaxaxaxaxadaxaxaxaxaxaxaxaxaxaxaxadaxaxaxaxaxadaIaIaIaIaIaIaIaIaIaIaIaIaIaIaIaIadaeaeaeaeaeadabababab
abababababababaaaaaaaaaaaaaaanaaaaaaaaaaaaatacacacapaaaaadaFaFaFaFaFaBaFaFaFaFaFaFaFaFadanananananadadadadadadadaQaxaxaxaxaxaxaxaxaxadaxaxaxaxaxadaIaIaIaIaIaIaIaIaIaIaIaIaIaIaIaIadaeaeaeaeaeadabababab
ababababababaaaaaaaaaaaaaaaaanaaaaaaaaaaaaatacacacapaaaaadaFaFaFaFaFaBaFaFaFaFaFaFaFaFadaaaaaaaaaaadaRaRaRaRaRadaxaxaxaxaxaxaxadadadadaxaxaxaxaxadaIaIaIaIaIaIaIaIaIaIaIaIaIaIaIaIadaeaeaeaeaeadadadadad
ababababababaaaaaaaaaaaaaaaaanaaaaaaaaaaaaatacacacapaaaaadaFaFaFaFaFaBaBaBaBaBaBaBaBaBadaaaaaaaaaaadaRaxaxaxaxadaxaxaxaxaxaxaxadaxaxaxaxaxaxaxaOadaIaIaIaIaIaIaIaIaIaIaIaIaIaIaIaIadaeaeaeaeaeadaeaeaead
ababababababaaaaaaaaaaaaaaaaanaaaaaaaaaaaaatacacacaSafafadaKaLaMadaNaBaFaFaFaFaFaFaFaFadaaaaaaaaaaadaRaxaTaxaxaUaxaxaxaxaxaxaxadaxaxaxaxaxaxaxaxadaIaIaIaIaIaIaIaIaIaIaIaIaIaIaIaIadauaeaeaeaeadagaeaead
abababababaaaaaaaaaaaaaaaaaaanaaaaaaaaaaaaatacacacacacacaAazazazayaBaBaFaFaFaFaFaFaFaGadaaaaaaaaaaadaRaxaxaxaxadaxaxaxaxaxaxaxaxaxaxaxaxaxaxaxaxadaIaIaIaIaIaIaIaIaIaIaIaIaIaIaIaIadaeaeaeaeaeadaeaeaead
ababababaaaaaaaaaaaaaaaaaaaaanaaaaaaaaaaaaatacacacacacacaEazazazaDaBaBaBaBaBaBaBaBaBaBadaaaaaaaaaaadaxaxaVaxaxadaxaxaxaxaxaxaxaWaxaxaVaxaxaxaxaxadaIaIaXaIaIadadaYaIadadaIaIaXaIaIadaeaeaeaeaeaeaeaeaead
ababababaaaaaaaaaaaaaaaaaaaaanaaaaaaaaaaaaatacacacaZajajadadadadadadadadadadadadadadadadanananananadadadadadadadadadadadadadadadawaxadawaxadadadadadadadaIaIadaIaIaIaIadaIaIadadadadaeaeaeaeaeadadadadad
abababababaaaaaaaaaaaaaaaaaaanaaaaaaaaaaaaatacacacapaaaaanaaaaaaaaaaaaaaaaaaaaaaaaaaaaanaaaaaaaaaaaaaaaaaaaaaaaaaaaaaaaaaaaaaaadaeaeaeaeaeadbababababaadaIaIadbbaIaIbcadaIaIadaeaeaeaeaeaeaeaeaeaebdadab
abababababaaaaaaaaaaaaaaaaaaanaaaaaaaaaaaaatacacacapaaaaanaaaaaaaaaaaaaaaaaaaaaaaaaaaaanaaaaaaaaaaaaaaaaaaaaaaaaaaaaaaaaaaaaaaadaeaeaeaeaeadaxaxaxaxaxbeaIaIadaIaIaIaIadaIaIadaeaaaaaaaaaaaaaaaaaaaeadab
ababababababababaaaaaaaaaaaaanaaaaaaaaaaaaatacacacapaaaaanaaaaaaaaaaaaaaaaaaaaaaaaaaaaanaaaaaaaaaaaaaaaaaaaaaaaaaaaaaaaaaaaaadadaeaeaeaeaeadaxaxaxaxaxadadadadadaYaIadadadadadaeaaaaaaaaaaaaaaaaaaaeadab
ababababababababababaaaaaaaaanaaaaaaaaaaaaatacacacbfafafbgafafafafafafafafafafafafafafbgafafafafafafafafafafafafafafafafafafadagaeaeaeaeaeaeaeaeaeaeaeaeaeaeaeaeaeaeaeaeaeaeaeaeaaaaaaaaaaaaaaaaaaaeadab
abababababababababababaaaaaaanaaaaaaaaaaaaatacacacacacacacacacacacacacacacacacacacacacacacacacacacacacacacacacacacacacacacacaeaeaeaeaeaeaeaeaeaeaeaeaeaeaeaeaeaeaeaeaeaeaeaeaeaeaaaaaaaaaaaaaaaaaaaeadab
abababababababababababababaaanaaaaaaaaaaaaatacacacacacacacacacacacacacacacacacacacacacacacacacacacacacacacacacacacacacacacacaeaeaeaeaeaeaeaeaeaeaeaeaeaeaeaeaeaeaeaeaeaeaeaeaeaeaaaaaaaaaaaaaaaaaabhadab
abababababababababababababaaanaaaaaaaaaaaaatacacacacacacacacacacacacacacacacacacacacacacacacacacacacacacacacacacacacacacacacaeaeaeaeaeaeaeaeaeaeaeaeaeaeaeaeaeaeaeaeaeaeaeaeaeaeaaaaaaaaaaaaaaaaaaaeadab
abababababababababababababababaaaaaaaaaaaabiajajajajajajajajajajajajajajajajajajajajajajajajajajajajajajajajajajajajabajajajadagaeaiaeaeaeaeaeaiaeaeaeaeaeaiaeaeaeaeaeaiaeaeaeaeaaaaaaaaaaaaaaaaaaaeadab
abababababababababababababababababaaaaaaaaaaaaaaaaaaaaaaaaaaaaaaaaaaaaaaaaaaaaaaaaaaaaaaaaaaaaaaabababaaaaaaaaaaaaaaababaaaaadadadadadadadadadadadadadadadadadadadadadadadadadaeaaaaaaaaaaaaaaaaaaaeadab
ababababababababababababababababababaaaaaaaaaaaaaaaaaaaaaaaaaaaaaaaaaaaaaaaaaaaaaaaaaaaaaaaaaaaaababababaaaaaaaaaaabababaaaaababababababababababababababababababababababababadaeaaaaaaaaaaaaaaaaaaaeadab
abababababababababababababababababababababaaaaaaaaaaaaaaaaabababababaaababaaaaaaaaaaaaababaaabababababababaaaaaaababababababababababababababababababababababababababababababadaeaeaeaeaebjaeaeaeaeaeadab
ababababababababababababababababababababababababababababababababababababababababababababababababababababababababababababababababababababababababababababababababababababababadadadadadadadadadadadadadab
"}
