"aa" = (/turf/simulated/outwards/stone,/area/outwards)
"ab" = (/turf/simulated/floor/outwards/snow,/area/outwards)
"ac" = (/obj/random/junk,/turf/simulated/floor/outwards/snow,/area/outwards)
"ad" = (/turf/simulated/wall/r_wall,/area/outwards)
"ae" = (/turf/simulated/floor/tiled/freezer,/area/outwards)
"af" = (/obj/effect/landmark/corpse/commander,/turf/simulated/floor/tiled/freezer,/area/outwards)
"ag" = (/obj/machinery/blackbox_recorder,/turf/simulated/floor/tiled/freezer,/area/outwards)
"ah" = (/obj/random/clothing,/turf/simulated/floor/tiled/freezer,/area/outwards)
"ai" = (/obj/random/junk,/turf/simulated/floor/tiled/freezer,/area/outwards)
"aj" = (/obj/random/advdevice,/turf/simulated/floor/tiled/freezer,/area/outwards)
"ak" = (/obj/effect/gibspawner/robot,/turf/simulated/floor/tiled/freezer,/area/outwards)
"al" = (/obj/random/toy,/turf/simulated/floor/tiled/freezer,/area/outwards)
"am" = (/obj/effect/landmark/corpse/scientist,/turf/simulated/floor/tiled/freezer,/area/outwards)
"an" = (/obj/effect/landmark/corpse/doctor,/turf/simulated/floor/tiled/freezer,/area/outwards)
"ao" = (/obj/machinery/constructable_frame/machine_frame,/turf/simulated/floor/tiled/freezer,/area/outwards)
"ap" = (/obj/structure/firedoor_assembly,/turf/simulated/floor/tiled/freezer,/area/outwards)
"aq" = (/obj/effect/gibspawner/human,/turf/simulated/floor/tiled/freezer,/area/outwards)
"ar" = (/obj/machinery/door/blast/regular,/turf/simulated/floor/tiled/freezer,/area/outwards)
"as" = (/obj/machinery/door/airlock/cone,/turf/simulated/floor/tiled/freezer,/area/outwards)
"at" = (/obj/machinery/door/blast/regular/open,/turf/simulated/floor/tiled/freezer,/area/outwards)
"au" = (/turf/simulated/outwards/ice,/area/outwards)
"av" = (/turf/simulated/wall/r_wall,/area/sector_a)
"aw" = (/obj/machinery/door/blast/regular,/turf/simulated/floor/tiled/dark,/area/sector_a)
"ax" = (/turf/simulated/floor/tiled/dark,/area/sector_a)
"ay" = (/obj/random/shoes,/turf/simulated/floor/tiled/dark,/area/sector_a)
"az" = (/obj/random/junk,/turf/simulated/floor/tiled/dark,/area/sector_a)
"aA" = (/obj/random/plushie,/turf/simulated/floor/tiled/dark,/area/sector_a)
"aB" = (/obj/random/closet,/turf/simulated/floor/tiled/dark,/area/sector_a)
"aC" = (/obj/random/soap,/turf/simulated/floor/tiled/dark,/area/sector_a)
"aD" = (/obj/random/toolbox,/turf/simulated/floor/tiled/dark,/area/sector_a)
"aE" = (/obj/machinery/light/spot{icon_state = "tube1"; dir = 1},/turf/simulated/floor/tiled/dark,/area/sector_a)
"aF" = (/obj/random/trash,/turf/simulated/floor/tiled/dark,/area/sector_a)
"aG" = (/obj/random/loot,/turf/simulated/floor/tiled/dark,/area/sector_a)
"aH" = (/obj/random/tool,/turf/simulated/floor/tiled/dark,/area/sector_a)
"aI" = (/obj/random/tank,/turf/simulated/floor/tiled/dark,/area/sector_a)
"aJ" = (/obj/machinery/door/blast/regular/open,/turf/simulated/floor,/area/sector_a)
"aK" = (/obj/machinery/door/blast/regular,/turf/simulated/floor,/area/sector_a)
"aL" = (/obj/random/powercell,/turf/simulated/floor/tiled/dark,/area/sector_a)
"aM" = (/obj/random/advdevice,/turf/simulated/floor/tiled/dark,/area/sector_a)
"aN" = (/turf/simulated/floor,/area/sector_a)
"aO" = (/obj/structure/grille,/obj/structure/window/phoronreinforced{icon_state = "phoronrwindow"; dir = 4},/obj/structure/window/phoronreinforced{icon_state = "phoronrwindow"; dir = 1},/obj/structure/window/phoronreinforced{icon_state = "phoronrwindow"; dir = 8},/turf/simulated/floor,/area/sector_a)
"aP" = (/obj/random/plushie/large,/turf/simulated/floor/tiled/dark,/area/sector_a)
"aQ" = (/obj/structure/grille,/obj/structure/window/phoronreinforced{icon_state = "phoronrwindow"; dir = 4},/obj/structure/window/phoronreinforced{icon_state = "phoronrwindow"; dir = 8},/turf/simulated/floor,/area/sector_a)
"aR" = (/obj/machinery/light/small/red{icon_state = "bulb1"; dir = 8},/turf/simulated/floor/tiled/dark,/area/sector_a)
"aS" = (/obj/structure/grille,/obj/structure/window/phoronreinforced,/obj/structure/window/phoronreinforced{icon_state = "phoronrwindow"; dir = 4},/obj/structure/window/phoronreinforced{icon_state = "phoronrwindow"; dir = 8},/turf/simulated/floor,/area/sector_a)
"aT" = (/obj/machinery/suit_storage_unit/mining,/turf/simulated/floor/tiled/dark,/area/sector_a)
"aU" = (/turf/simulated/open,/area/masslift/a)
"aV" = (/obj/structure/grille,/obj/structure/window/reinforced{icon_state = "rwindow"; dir = 8},/obj/structure/window/reinforced{icon_state = "rwindow"; dir = 1},/obj/structure/window/reinforced,/turf/simulated/floor/tiled/dark,/area/sector_a)
"aW" = (/obj/structure/grille,/obj/structure/window/reinforced{icon_state = "rwindow"; dir = 4},/obj/structure/window/reinforced{icon_state = "rwindow"; dir = 1},/obj/structure/window/reinforced,/turf/simulated/floor/tiled/dark,/area/sector_a)
"aX" = (/obj/machinery/door/airlock/mining,/turf/simulated/floor/tiled/dark,/area/sector_a)
"aY" = (/obj/effect/floor_decal/industrial/warning{icon_state = "warning"; dir = 9},/turf/simulated/floor/tiled/dark,/area/sector_a)
"aZ" = (/obj/effect/floor_decal/industrial/warning{icon_state = "warning"; dir = 1},/turf/simulated/floor/tiled/dark,/area/sector_a)
"ba" = (/obj/effect/floor_decal/industrial/warning{icon_state = "warning"; dir = 5},/turf/simulated/floor/tiled/dark,/area/sector_a)
"bb" = (/obj/machinery/light/spot{icon_state = "tube1"; dir = 4},/turf/simulated/floor/tiled/dark,/area/sector_a)
"bc" = (/obj/effect/floor_decal/industrial/warning{icon_state = "warning"; dir = 8},/turf/simulated/floor/tiled/dark,/area/sector_a)
"bd" = (/obj/effect/floor_decal/industrial/warning{icon_state = "warning"; dir = 4},/turf/simulated/floor/tiled/dark,/area/sector_a)
"be" = (/obj/effect/floor_decal/industrial/warning/full,/obj/vehicle/bike/electric,/turf/simulated/floor/tiled/dark,/area/sector_a)
"bf" = (/obj/effect/floor_decal/industrial/warning/full,/obj/vehicle/bike/thermal,/turf/simulated/floor/tiled/dark,/area/sector_a)
"bg" = (/obj/effect/floor_decal/industrial/warning/full,/turf/simulated/floor/tiled/dark,/area/sector_a)
"bh" = (/obj/effect/floor_decal/industrial/warning{icon_state = "warning"; dir = 10},/turf/simulated/floor/tiled/dark,/area/sector_a)
"bi" = (/obj/effect/floor_decal/industrial/warning,/turf/simulated/floor/tiled/dark,/area/sector_a)
"bj" = (/obj/effect/floor_decal/industrial/warning{icon_state = "warning"; dir = 6},/turf/simulated/floor/tiled/dark,/area/sector_a)
"bk" = (/obj/machinery/light/spot,/turf/simulated/floor/tiled/dark,/area/sector_a)
"bl" = (/obj/machinery/door/airlock/highsecurity,/turf/space,/area/sector_a)
"bm" = (/obj/effect/landmark/test/space_turf,/turf/simulated/floor/outwards/snow,/area/outwards)
"bn" = (/obj/effect/landmark/test/safe_turf,/turf/simulated/floor/tiled/dark,/area/sector_a)
"bo" = (/obj/effect/landmark/start,/turf/simulated/floor/tiled/dark,/area/sector_a)
"bp" = (/obj/machinery/light{icon_state = "tube1"; dir = 8},/turf/simulated/floor/tiled/dark,/area/sector_a)
"bq" = (/obj/masslift/extender,/obj/structure/cable,/turf/simulated/floor/tiled/dark,/area/sector_a)
"br" = (/obj/machinery/light{icon_state = "tube1"; dir = 4},/turf/simulated/floor/tiled/dark,/area/sector_a)
"bs" = (/obj/machinery/power/apc/hyper{dir = 1; icon_state = "apc0"; pixel_y = 32},/turf/simulated/floor/tiled/dark,/area/sector_a)

(1,1,1) = {"
aaaaaaaaaaaaaaaaaaaaaaaaaaaaaaaaaaaaaaaaaaaaaaaaaaaaaaaaaaaaaaaaaaaaaaaaaaaaaaaaaaaaaaaaaaaaaaaaaaaaaaaaaaaaaaaaaaaaaaaaaaabababababababaaaaaaaaaaaaaaaaaaaaaaaaaaaaaaaaaaaaaaaaaaaaaaaaaaaaaaaaaaaaaaaaaaaaaaaaaaaaaaaaaaaa
aaaaaaaaaaaaaaaaaaaaaaaaaaaaaaaaaaaaaaaaaaaaaaaaaaaaaaaaaaaaaaaaaaaaaaaaaaaaaaaaaaaaaaaaaaaaaaaaaaaaaaaaaaaaaaaaaaaaaaaaaaababababababaaaaaaaaaaaaaaaaaaaaaaaaaaaaaaaaaaaaaaaaaaaaaaaaaaaaaaaaaaaaaaaaaaaaaaaaaaaaaaaaaaaaaa
aaaaaaaaaaaaaaaaaaaaaaaaaaaaaaaaaaaaaaaaaaaaaaaaaaaaaaaaaaaaaaaaaaaaaaaaaaaaaaaaaaaaaaaaaaaaaaaaaaaaaaaaaaaaaaaaaaaaaaaaabababababababaaaaaaaaaaaaaaaaaaaaaaaaaaaaaaaaaaaaaaaaaaaaaaaaaaaaaaaaaaaaaaaaaaaaaaaaaaaaaaaaaaaaaa
aaaaaaaaaaaaaaaaaaaaaaaaaaaaaaaaaaaaaaaaaaaaaaaaaaaaaaaaaaaaaaaaaaaaaaaaaaaaaaaaaaaaaaaaaaaaaaaaaaaaaaaaaaaaaaaaaaaaaaababababababababaaaaaaaaaaaaaaaaaaaaaaaaaaaaaaaaaaaaaaaaaaaaaaaaaaaaaaaaaaaaaaaaaaaaaaaaaaaaaaaaaaaaaa
aaaaaaaaaaaaaaaaaaaaaaaaaaaaaaaaaaaaaaaaaaaaaaaaaaaaaaaaaaaaaaaaaaaaaaaaaaaaaaaaaaaaaaaaaaaaaaaaaaaaaaaaaaaaaaaaaaaaaaabababababababaaaaaaaaaaaaaaaaaaaaaaaaaaaaaaaaaaaaaaaaaaaaaaaaaaaaaaaaaaaaaaaaaaaaaaaaaaaaaaaaaaaaaaaa
aaaaaaaaaaaaaaaaaaaaaaaaaaaaaaaaaaaaaaaaaaaaaaaaaaaaaaaaaaaaaaaaaaaaaaaaaaaaaaaaaaaaaaaaaaaaaaaaaaaaaaaaaaaaaaaaaaaaabababababababaaaaaaaaaaaaaaaaaaaaaaaaaaaaaaaaaaaaaaaaaaaaaaaaaaaaaaaaaaaaaaaaaaaaaaaaaaaaaaaaaaaaaaaaaa
aaaaaaaaaaaaaaaaaaaaaaaaaaaaaaaaaaaaaaaaaaaaaaaaaaaaaaaaaaaaaaaaaaaaaaaaaaaaaaaaaaaaaaaaaaaaaaaaaaaaaaaaaaaaaaaaaaababababababababaaaaaaaaaaaaaaaaaaaaaaaaaaaaaaaaaaaaaaaaaaaaaaaaaaaaaaaaaaaaaaaaaaaaaaaaaaaaaaaaaaaaaaaaaa
aaaaaaaaaaaaaaaaaaaaaaaaaaaaaaaaaaaaaaaaaaaaaaaaaaaaaaaaaaaaaaaaaaaaaaaaaaaaaaaaaaaaaaaaaaaaaaaaaaaaaaaaaaaaaaaaaaabababababababaaaaaaaaaaaaaaaaaaaaaaaaaaaaaaaaaaaaaaaaaaaaaaaaaaaaaaaaaaaaaaaaaaaaaaaaaaaaaaaaaaaaaaaaaaaa
aaaaaaaaaaaaaaaaaaaaaaaaaaaaaaaaaaaaaaaaaaaaaaaaaaaaaaaaaaaaaaaaaaaaaaaaaaaaaaaaaaaaaaaaaaaaaaaaaaaaaaaaaaaaaaaaabababababababaaaaaaaaaaaaaaaaaaaaaaaaaaaaaaaaaaaaaaaaaaaaaaaaaaaaaaaaaaaaaaaaaaaaaaaaaaaaaaaaaaaaaaaaaaaaaa
aaaaaaaaaaaaaaaaaaaaaaaaaaaaaaaaaaaaaaaaaaaaaaaaaaaaaaaaaaaaaaaaaaaaaaaaaaaaaaaaaaaaaaaaaaaaaaaaaaaaaaaaaaaaaaabababababababaaaaaaaaaaaaaaaaaaaaaaaaaaaaaaaaaaaaaaaaaaaaaaaaaaaaaaaaaaaaaaaaaaaaaaaaaaaaaaaaaaaaaaaaaaaaaaaa
aaaaaaaaaaaaaaaaaaaaaaaaaaaaaaaaaaaaaaaaaaaaaaaaaaaaaaaaaaaaaaaaaaaaaaaaaaaaaaaaaaaaaaaaaaaaaaaaaaaaaaaaaaaaaaababababababaaaaaaaaaaaaaaaaaaaaaaaaaaaaaaaaaaaaaaaaaaaaaaaaaaaaaaaaaaaaaaaaaaaaaaaaaaaaaaaaaaaaaaaaaaaaaaaaaa
aaaaaaaaaaaaaaaaaaaaaaaaaaaaaaaaaaaaaaaaaaaaaaaaaaaaaaaaaaaaaaaaaaaaaaaaaaaaaaaaaaaaaaaaaaaaaaaaaaaaaaaaaaaaababababababaaaaaaaaaaaaaaaaaaaaaaaaaaaaaaaaaaaaaaaaaaaaaaaaaaaaaaaaaaaaaaaaaaaaaaaaaaaaaaaaaaaaaaaaaaaaaaaaaaaa
aaaaaaaaaaaaaaaaaaaaaaaaaaaaaaaaaaaaaaaaaaaaaaaaaaaaaaaaaaaaaaaaaaaaaaaaaaaaaaaaaaaaaaaaaaaaaaaaaaaaaaaaaaababababababaaaaaaaaaaaaaaaaaaaaaaaaaaaaaaaaaaaaaaaaaaaaaaaaaaaaaaaaaaaaaaaaaaaaaaaaaaaaaaaaaaaaaaaaaaaaaaaaaaaaaa
aaaaaaaaaaaaaaaaaaaaaaaaaaaaaaaaaaaaaaaaaaaaaaaaaaaaaaaaaaaaaaaaaaaaaaaaaaaaaaaaaaaaaaaaaaaaaaaaaaaaaaaaaaabababababaaaaaaaaaaaaaaaaaaaaaaaaaaaaaaaaaaaaaaaaaaaaaaaaaaaaaaaaaaaaaaaaaaaaaaaaaaaaaaaaaaaaaaaaaaaaaaaaaaaaaaaa
aaaaaaaaaaaaaaaaaaaaaaaaaaaaaaaaaaaaaaaaaaaaaaaaaaaaaaaaaaaaaaaaaaaaaaaaaaaaaaaaaaaaaaaaaaaaaaaaaaaaaaaaabababababaaaaaaaaaaaaaaaaaaaaaaaaaaaaaaaaaaaaaaaaaaaaaaaaaaaaaaaaaaaaaaaaaaaaaaaaaaaaaaaaaaaaaaaaaaaaaaaaaaaaaaaaaa
aaaaaaaaaaaaaaaaaaaaaaaaaaaaaaaaaaaaaaaaaaaaaaaaaaaaaaaaaaaaaaaaaaaaaaaaaaaaaaaaaaaaaaaaaaaaaaaaaaaaaaaaabababababaaaaaaaaaaaaaaaaaaaaaaaaaaaaaaaaaaaaaaaaaaaaaaaaaaaaaaaaaaaaaaaaaaaaaaaaaaaaaaaaaaaaaaaaaaaaaaaaaaaaaaaaaa
aaaaaaaaaaaaaaaaaaaaaaaaaaaaaaaaaaaaaaaaaaaaaaaaaaaaaaaaaaaaaaaaaaaaaaaaaaaaaaaaaaaaaaaaaaaaaaaaaaaaaaabababababaaaaaaaaaaaaaaaaabababababaaaaaaaaaaaaaaaaaaaaaaaaaaaaaaaaaaaaaaaaaaaaaaaaaaaaaaaaaaaaaaaaaaaaaaaaaaaaaaaaaa
aaaaaaaaaaaaaaaaaaaaaaaaaaaaaaaaaaaaaaaaaaaaaaaaaaaaaaaaaaaaaaaaaaaaaaaaaaaaaaaaaaaaaaaaaaaaaaaaaaaaaaabababababaaaaaaaaaaaaaaababababababababaaaaaaaaaaaaaaaaaaaaaaaaaaaaaaaaaaaaaaaaaaaaaaaaaaaaaaaaaaaaaaaaaaaaaaaaaaaaaa
aaaaaaaaaaaaaaaaaaaaaaaaaaaaaaaaaaaaaaaaaaaaaaaaaaaaaaaaaaaaaaaaaaaaaaaaaaaaaaaaaaaaaaaaaaaaaaaaaaaaaaaaababababaaaaaaaaaaababababababababababaaaaaaaaaaaaaaaaaaaaaaaaaaaaaaaaaaaaaaaaaaaaaaaaaaaaaaaaaaaaaaaaaaaaaaaaaaaaaa
aaaaaaaaaaaaaaaaaaaaaaaaaaaaaaaaaaaaaaaaaaaaaaaaaaaaaaaaaaaaaaaaaaaaaaaaaaaaaaaaaaaaaaaaaaaaaaaaaaaaaaaaababababababababaaaaababababababababababaaaaaaaaaaaaaaaaaaaaaaaaaaaaaaaaaaaaaaaaaaaaaaaaaaaaaaaaaaaaaaaaaaaaaaaaaaaa
aaaaaaaaaaaaaaaaaaaaaaaaaaaaaaaaaaaaaaaaaaaaaaaaaaaaaaaaaaaaaaaaaaaaaaaaaaaaaaaaaaaaaaaaaaaaaaaaaaaaaaaaababababababababababaaabababababababababaaaaaaaaaaaaaaaaaaaaaaaaaaaaaaaaaaaaaaaaaaaaaaaaaaaaaaaaaaaaaaaaaaaaaaaaaaaa
aaaaaaaaaaaaaaaaaaaaaaaaaaaaaaaaaaaaaaaaaaaaaaaaaaaaaaaaaaaaaaaaaaaaaaaaaaaaaaaaaaaaaaaaaaaaaaaaaaaaaaaaaaaaabababababababababababababababababaaaaaaaaaaaaaaaaaaaaaaaaaaaaaaaaaaaaaaaaaaaaaaaaaaaaaaaaaaaaaaaaaaaaaaaaaaaaaa
aaaaaaaaaaaaaaaaaaaaaaaaaaaaaaaaaaaaaaaaaaaaaaaaaaaaaaaaaaaaaaaaaaaaaaaaaaaaaaaaaaaaaaaaaaaaaaaaaaaaaaaaaaaaaaaaababababababababababababababaaaaaaabababababaaaaaaaaaaaaaaaaaaaaaaaaaaaaaaaaaaaaaaaaaaaaaaaaaaaaaaaaaaaaaaaa
aaaaaaaaaaaaaaaaaaaaaaaaaaaaaaaaaaaaaaaaaaaaaaaaaaaaaaaaaaaaaaaaaaaaaaaaaaaaaaaaaaaaaaaaaaaaaaaaaaaaaaaaaaaaaaaaaaaaabababababababababababaaaaabababababababababaaaaaaaaaaaaaaaaaaaaaaaaaaaaaaaaaaaaaaaaaaaaaaaaaaaaaaaaaaaa
aaaaaaaaaaaaaaaaaaaaaaaaaaaaaaaaaaaaaaaaaaaaaaaaaaaaaaaaaaaaaaaaaaaaaaaaaaaaaaaaaaaaaaaaaaaaaaaaaaaaaaaaaaaaaaaaaaaaaaababababababababababaaababababababababababababaaaaaaaaaaaaaaaaaaaaaaaaaaaaaaaaaaaaaaaaaaaaaaaaaaaaaaaa
aaaaaaaaaaaaaaaaaaaaaaaaaaaaaaaaaaaaaaaaaaaaaaaaaaaaaaaaaaaaaaaaaaaaaaaaaaaaaaaaaaaaaaaaaaaaaaaaaaaaaaaaaaaaaaaaaaaaaaabababababababababaaaaababababababababaaaaaaaaaaaaaaaaaaaaaaaaaaaaaaaaaaaaaaaaaaaaaaaaaaaaaaaaaaaaaaaa
aaaaaaaaaaaaaaaaaaaaaaaaaaaaaaaaaaaaaaaaaaaaaaaaaaaaaaaaaaaaaaaaaaaaaaaaaaaaaaaaaaaaaaaaaaaaaaaaaaaaaaaaaaaaababaaaaaaaaabababababababaaaaaaaaabababababababaaaaaaaaaaaaaaaaaaaaaaaaaaaaaaaaaaaaaaaaaaaaaaaaaaaaaaaaaaaaaaaa
aaaaaaaaaaaaaaaaaaaaaaaaaaaaaaaaaaaaaaaaaaaaaaaaaaaaaaaaaaaaaaaaaaaaaaaaaaaaaaaaaaaaaaaaaaaaaaaaaaaaaaaaabababababaaaaaaaaaaaaabababababaaaaaaaaaaabababababaaaaaaaaaaaaaaaaaaaaaaaaaaaaaaaaaaaaaaaaaaaaaaaaaaaaaaaaaaaaaaaa
aaaaaaaaaaaaaaaaaaaaaaaaaaaaaaaaaaaaaaaaaaaaaaaaaaaaaaaaaaaaaaaaaaaaaaaaaaaaaaaaaaaaaaaaaaaaaaaaaaaaaaabababababababaaaaaaaaaaaaabababababaaaaaaaaaaabababababaaaaaaaaaaaaaaaaaaaaaaaaaaaaaaaaaaaaaaaaaaaaaaaaaaaaaaaaaaaaaa
aaaaaaaaaaaaaaaaaaaaaaaaaaaaaaaaaaaaaaaaaaaaaaaaaaaaaaaaaaaaaaaaaaaaaaaaaaaaaaaaaaaaaaaaaaaaaaaaaaaaababababababababaaaaaaaaaaaaababababababaaaaaaaaaaababababaaaaaaaaaaaaaaaaaaaaaaaaaaaaaaaaaaaaaaaaaaaaaaaaaaaaaaaaaaaaaa
aaaaaaaaaaaaaaaaaaaaaaaaaaaaaaaaaaaaaaaaaaaaaaaaaaaaaaaaaaaaaaaaaaaaaaaaaaaaaaaaaaaaaaaaaaaaaaaaaaabababababaaaaabababaaaaaaaaababababababababaaaaaaaaaaababababaaaaaaaaaaaaaaaaaaaaaaaaaaaaaaaaaaaaaaaaaaaaaaaaaaaaaaaaaaaa
aaaaaaaaaaaaaaaaaaaaaaaaaaaaaaaaaaaaaaaaaaaaaaaaaaaaaaaaaaaaaaaaaaaaaaaaaaaaaaaaaaaaaaaaaaaaaaaaababababaaaaaaaaabababaaaaaaaaabababababababaaaaaaaaaaaaabababababababaaaaaaaaaaaaaaaaaaaaaaaaaaaaaaaaaaaaaaaaaaaaaaaaaaaaaa
aaaaaaaaaaaaaaaaaaaaaaaaaaaaaaaaaaaaaaaaaaaaaaaaaaaaaaaaaaaaaaaaaaaaaaaaaaaaaaaaaaaaaaaaaaaaaaaaababababaaaaaaabababaaaaaaaaaaababababababaaaaaaaaaaaaababababababababababaaaaaaaaaaaaaaaaaaaaaaaaaaaaaaaaaaaaaaaaaaaaaaaaaa
aaaaaaaaaaaaaaaaaaaaaaaaaaaaaaaaaaaaaaaaaaaaaaaaaaaaaaaaaaaaaaaaaaaaaaaaaaaaaaaaaaaaaaaaaaaaaaabababaaaaaaaaabababaaaaaaaaaaabababababaaaaaaaaaaaaababababababababababababaaaaaaaaaaaaaaaaaaaaaaaaaaaaaaaaaaaaaaaaaaaaaaaaaa
aaaaaaaaaaaaaaaaaaaaaaaaaaaaaaaaaaaaaaaaaaaaaaaaaaaaaaaaaaaaaaaaaaaaaaaaaaaaaaaaaaaaaaaaaaaaaaababaaaaaaaaaaababaaaaaaaaaaabababababaaaaaaaaaaaaababababababababababababababaaaaaaaaaaaaaaaaaaaaaaaaaaaaaaaaaaaaaaaaaaaaaaaa
aaaaaaaaaaaaaaaaaaaaaaaaaaaaaaaaaaaaaaaaaaaaaaaaaaaaaaaaaaaaaaaaaaaaaaaaaaaaaaaaaaaaaaaaaaaaaaababaaaaaaaaaaababaaaaaaaaabababababaaaaaaaaaaaaababababababababababababababababaaaaaaaaaaaaaaaaaaaaaaaaaaaaaaaaaaaaaaaaaaaaaa
aaaaaaaaaaaaaaaaaaaaaaaaaaaaaaaaaaaaaaaaaaaaaaaaaaaaaaaaaaaaaaaaaaaaaaaaaaaaaaaaaaaaaaaaaaaaababaaaaaaaaabababaaaaaaaaababababababaaaaaaaaaaabababababababababababababababababaaaaaaaaaaaaaaaaaaaaaaaaaaaaaaaaaaaaaaaaaaaaaa
aaaaaaaaaaaaaaaaaaaaaaaaaaaaaaaaaaaaaaaaaaaaaaaaaaaaaaaaaaaaaaaaaaaaaaaaaaaaaaaaaaaaaaaaaaababaaaaaaaaababababaaaaaaabababababababaaaaaaaaababababababababababababababababababaaaaaaaaaaaaaaaaaaaaaaaaaaaaaaaaaaaaaaaaaaaaaa
aaaaaaaaaaaaaaaaaaaaaaaaaaaaaaaaaaaaaaaaaaaaaaaaaaaaaaaaaaadadadadadadadadaaaaaaaaaaaaaaaaababaaaaaaaaabababaaaaaaaaababababababaaaaaaaaaaababababababababababababababababababaaaaaaaaaaaaaaaaaaaaaaaaaaaaaaaaaaaaaaaaaaaaaa
aaaaaaaaaaaaaaaaaaaaaaaaaaaaaaaaaaaaaaaaaaaaaaaaaaaaaaaaaaadaeaeaeafaeagadaaaaaaaaaaaaaaabababaaaaaaababababaaaaaaaaabababababaaaaaaaaaaaaaaaaaaaaababababababababababababababaaaaaaaaaaaaaaaaaaaaaaaaaaaaaaaaaaaaaaaaaaaaaa
aaaaaaaaaaaaaaaaaaaaaaaaaaaaaaaaaaaaaaaaaaaaaaaaaaaaaaaaaaadahaiaeajaeaeadaaaaaaaaaaaaaaababaaaaaaaaaaababababaaaaaaabababababaaaaaaaaaaaaaaaaaaabababababababababababababababaaaaaaaaaaaaaaaaaaaaaaaaaaaaaaaaaaaaaaaaaaaaaa
aaaaaaaaaaaaaaaaaaaaaaaaaaaaaaaaaaaaaaaaaaaaaaaaaaaaaaaaaaadaeakalaiaiaeadaaaaaaaaaaaaabababaaaaaaaaaaababababaaaaaaaaababababaaaaaaaaaaaaaaaaabababababaaaaabababababababababaaaaaaaaaaaaaaaaaaaaaaaaaaaaaaaaaaaaaaaaaaaaaa
aaaaaaaaaaaaaaaaaaaaaaaaaaaaaaaaaaaaaaaaaaaaaaaaaaaaaaaaaaadaeaiaeahaeaeadaaaaaaaaaaaaababababaaaaaaaaababababaaaaaaauauababababaaaaaaaaaaaaababababaaaaaaaaabababababababababaaaaaaaaaaaaaaaaaaaaaaaaaaaaaaaaaaaaaaaaaaaaaa
aaaaaaaaaaaaaaaaaaaaaaaaaaaaaaaaaaaaaaaaaaaaaaaaaaaaaaaaaaadaeaeamaeaeaiadadadadadadaaaaababaaaaaaaaabababababaaauauauauauababababababababababababaaaaaaaaaaaaabababababababaaaaaaaaaaaaaaaaaaaaaaaaaaaaaaaaaaaaaaaaaaaaaaaa
aaaaaaaaaaaaaaaaaaaaaaaaaaaaaaaaaaaaaaaaaaaaaaaaaaaaaaaaaaadanaeaeaiaeaeadaoaoaoaoadadadadabababaaabababababababauauauauabababababababababababababaaaaaaaaaaaaaaababababababaaaaaaaaaaaaaaaaaaaaaaaaaaaaaaaaaaaaaaaaaaaaaaaa
aaaaaaaaaaaaaaaaaaaaaaaaaaaaaaaaaaaaaaaaaaaaaaaaaaaaaaaaaaadaeaiaeaeamapadaiaeaqaearaeaeadaaabababababababababababauauaaaaabababababababababababababababaaaaaaaaababababababaaaaaaaaaaaaaaaaaaaaaaaaaaaaaaaaaaaaaaaaaaaaaaaa
aaaaaaaaaaaaaaaaaaaaaaaaaaaaaaaaaaaaaaaaaaaaaaaaaaaaaaaaaaadaeaeaeaeaeaeasaeaeaeaeataiaeadaaaaaaaaaaabababababababababaaaaaaaaababababababababababababababaaaaababababababaaaaaaaaaaaaaaaaaaaaaaaaaaaaaaaaaaaaaaaaaaaaaaaaaa
aaaaaaaaaaaaaaaaaaaaaaaaaaaaaaaaaaaaaaaaaaaaaaaaaaaaaaaaaaadadadadadadadadadadadadadaratadaaaaaaaaaaaaaaababababababababaaaaaaaaaaababababababababababababababababababababaaaaaaaaaaaaaaaaaaaaaaaaaaaaaaaaaaaaaaaaaaaaaaaaaa
aaaaaaaaaaaaaaaaaaaaaaaaaaaaaaaaaaaaaaaaaaaaaaaaaaaaaaaaaaaaaaaaaaaaaaaaaaaaaaaaaaabababababaaaaaaaaaaaaaaaaabababababababaaaaaaaaaaaaaaababababababababababababababababaaaaaaaaaaaaaaaaaaaaaaaaaaaaaaaaaaaaaaaaaaaaaaaaaaaa
aaaaaaaaaaaaaaaaaaaaaaaaaaaaaaaaaaaaaaaaaaaaaaaaaaaaaaaaaaaaaaaaaaaaaaaaaaaaabababababababacabaaaaaaaaaaaaaaaaaaabababababababaaaaaaaaaaaaaaabababababababababababababaaaaaaaaaaaaaaaaaaaaaaaaaaaaaaaaaaaaaaaaaaaaaaaaaaaaaa
aaaaaaaaaaaaaaaaaaaaaaaaaaaaaaaaaaaaaaaaaaaaaaaaaaaaaaaaaaaaaaaaaaaaaaababababababacabababababababababaaaaaaaaaaaaabababababababaaaaaaaaaaaaababababababaaaaabababababaaaaaaaaaaaaaaaaaaaaaaaaaaaaaaaaaaaaaaaaaaaaaaaaaaaaaa
aaaaaaaaaaaaabababababababaaaaaaaaaaaaaaaaaaaaaaaaaaaaaaaaaaaaababababababababababababababababababababababaaaaaaaaaaabababababababababababababababababaaaaaaaaababababaaaaaaaaaaaaaaaaaaaaaaaaaaaaaaaaaaaaaaaaaaaaaaaaaaaaaa
aaaaaaaaaaabababababababababaaaaaaaaaaaaaaaaaaaaaaaaababababababababababababababababababababababababababababababababababababababababababababababaaaaaaaaaaaaaaababababaaaaaaaaaaaaaaaaaaaaaaaaaaaaaaaaaaaaaaaaaaaaaaaaaaaaaa
aaaaaaababababababababababababaaaaaaaaaaaaaaaaaaababababababababababababababababababababababababababababababababababababababababaaaaaaaaaaaaabaaaaaaaaaaaaaaabababababaaaaaaaaaaaaaaaaaaaaaaaaaaaaaaaaaaaaaaaaaaaaaaaaaaaaaa
abababababababababababababababababaaaaaaaaaaaaaaabababababababababababababababababababababababababababababababababababaaaaaaaaaaaaaaaaaaaaaaaaaaaaaaaaaaaaabababababababaaaaaaaaaaaaaaaaaaaaaaaaaaaaaaaaaaaaaaaaaaaaaaaaaaaa
abababababababababababababababababababaaaaaaaaaaaaaaaaaaababababababababababababababababababababababababababababaaaaaaaaaaaaaaaaaaaaaaaaaaaaaaaaaaaaaaababababababababababaaaaaaaaaaaaaaaaaaaaaaaaaaaaaaaaaaaaaaaaaaaaaaaaaa
abababababababababababababababababababababaaaaaaaaaaaaaaaaabababababababababababababababababababababaaaaaaaaaaaaaaaaaaaaaaaaaaaaaaaaaaaaaaababababababababababababababababaaaaaaaaaaaaaaaaaaaaaaaaaaaaaaaaaaaaaaaaaaaaaaaaaa
abababababababababaaaaaaaaababababababababababaaaaaaaaaaaaaaabababababababababababababababababaaaaaaaaaaaaaaaaaaaaaaaaaaaaaaaaaaabababababababababababababababababababababaaaaaaaaaaaaaaaaaaaaaaaaaaaaaaaaaaaaaaaaaaaaaaaaaa
abababababaaaaaaaaaaaaaaaaaaabababababababababababaaaaaaaaaaaaabababababababababababababauaaaaaaaaaaaaaaaaaaaaaaaaaaaaabababababababababababababababababababababababababababaaaaaaaaaaaaaaaaaaaaaaaaaaaaaaaaaaaaaaaaaaaaaaaa
aaaaaaaaaaaaaaaaaaaaaaaaaaaaaaabababababababababababaaaaaaaaaaaaabababababababaaaaauauauauaaaaaaaaaaaaaaabababababababababababababababababababababababababababababababababababaaaaaaaaaaaaaaaaaaaaaaaaaaaaaaaaaaaaaaaaaaaaaa
aaaaaaaaaaaaaaaaaaaaaaaaaaaaaaaaabababababababababababaaaaaaaaaaabababababaaaaaaaaauauauauauaaaaababababababababababababababababababababababababababababababababababababababababaaaaaaaaaaaaaaaaaaaaaaaaaaaaaaaaaaaaaaaaaaaa
aaaaaaaaaaaaaaaaaaaaaaaaaaaaaaaaaaaaababababababababababaaaaaaaaaaababaaaaaaaaaaaaaaauauauauauabababababababababababababababababababababababababababababababababababababababababaaaaaaaaaaaaaaaaaaaaaaaaaaaaaaaaaaaaaaaaaaaa
aaaaaaaaaaaaaaaaaaaaaaaaaaaaaaaaaaaaaaaaaaababababababababaaaaaaaaaaaaaaaaaaaaaaaaaaabababababababababababababababababababababababababababababababababababababababababababababababaaaaaaaaaaaaaaaaaaaaaaaaaaaaaaaaaaaaaaaaaa
aaaaaaaaaaaaaaaaaaaaaaaaaaaaaaaaaaaaaaaaaaaaaaabababababababaaaaaaaaaaaaaaaaaaaaababababababababababababababababababababababababababababababababababababababababababababababababababaaaaaaaaaaaaaaaaaaaaaaaaaaaaaaaaaaaaaaaa
aaaaaaaaaaaaaaaaaaaaaaaaaaaaaaaaaaaaaaaaaaaaaaaaaaabababababababaaaaaaaaaaaaababababababababababababababababababababababababababababababababababababababababababababababababababababaaaaaaaaaaaaaaaaaaaaaaaaaaaaaaaaaaaaaaaa
aaaaaaaaaaaaaaaaaaaaaaaaaaaaaaaaaaaaaaaaaaaaaaaaaaaaaaabababababababaaaaabababababababababababababababababababababababababababababababababababababababababababababababababababababababaaaaaaaaaaaaaaaaaaaaaaaaaaaaaaaaaaaaaa
aaaaaaaaaaaaaaaaaaaaaaaaaaaaaaaaaaaaaaaaaaaaaaaaaaaaaaaaabababababababababababababababababababababababababababababababababababababababababababababababababababababababababababababababaaaaaaaaaaaaaaaaaaaaaaaaaaaaaaaaaaaaaa
aaaaaaaaaaaaaaaaaaaaaaaaaaaaaaaaaaaaaaaaaaaaaaaaaaaaaaaaaaababababababababababababababababababababababababababababababababababababababababababababababababababababababababababababababaaaaaaaaaaaaaaaaaaaaaaaaaaaaaaaaaaaaaa
aaaaaaaaaaaaaaaaaaaaaaaaaaaaaaaaaaaaaaaaaaaaaaaaaaaaaaaaaaababababababababababababababababababababababababababababababababababababababababababababababababababababababababababababababaaaaaaaaaaaaaaaaaaaaaaaaaaaaaaaaaaaaaa
aaaaaaaaaaaaaaaaaaaaaaaaaaaaaaaaaaaaaaaaaaaaaaaaaaaaaaaaababababababababababababababababababababababababababababababababababababababababababababababababababababababababababababababababaaaaaaaaaaaaaaaaaaaaaaaaaaaaaaaaaaaa
aaaaaaaaaaaaaaaaaaaaaaaaaaaaaaaaaaaaaaaaaaaaaaaaaaaaababababababababababababababababababababababababababababababababababababababababababababababababababababababababababababababababababaaaaaaaaaaaaaaaaaaaaaaaaaaaaaaaaaaaa
aaaaaaaaaaaaaaaaaaaaaaaaaaaaaaaaaaaaaaaaaaaaaaaaaaababababababababababababababababababababababababababababababababababababababababababababababababababababababababababababababababababababaaaaaaaaaaaaaaaaaaaaaaaaaaaaaaaaaa
aaaaaaaaaaaaaaaaaaaaaaaaaaaaaaaaaaaaaaaaabababababababababababababababababababababababababababababababababababababababababababababababababababababababababababababababababababababababababaaaaaaaaaaaaaaaaaaaaaaaaaaaaaaaaaa
aaaaaaaaaaaaaaaaaaaaaaaaaaaaaaaaaaabababababababababababababababababababababababababababababababababababababababababababababababababababababababababababababababababababababababababababababaaaaaaaaaaaaaaaaaaaaaaaaaaaaaaaa
aaaaaaaaaaaaaaaaaaaaaaaaaaaaabababababababababababababababababababababababababababababababababababababababababababababababababababababababababababababababababababababababababaaaaababababababaaaaaaaaaaaaaaaaaaaaaaaaaaaaaa
aaaaaaaaaaaaaaaaaaaaaaaaaaababababababababababababababababababababababababababauauauabababababababababababababababababababababababababababababababababababababababababababaaaaaaaaababababababaaaaaaaaaaaaaaaaaaaaaaaaaaaaaa
aaaaaaaaaaaaaaaaaaaaaaaaabababababababababababababababababababababababababauauauauauabababababababababababababababababababababababababababababababababababababababbmababaaaaaaaaaaabababababababaaaaaaaaaaaaaaaaaaaaaaaaaaaa
aaaaaaaaaaaaaaaaaaaaaaabababababababababababababababababababababababababababauauauabababababababababababababababababababababababababababababababababababababababababaaaaaaaaaaaaavawawawawawawawavaaaaaaaaaaaaaaaaaaaaaaaaaa
aaaaaaaaaaaaaaaaabababababababababababababababababababababababababababababababababababababababababababababababababababababababababababababababababababababababababaaaaaaaaaaavavavaxaxaxaxaxayaxavavavaaaaaaaaaaaaaaaaaaaaaa
aaaaaaaaaaaaabababababababababababababababababababababababababababababababababababababababababababababababababababababababababababababababababababababababababaaaaaaaaaaaaaaavaxaxaxaxazaxaAaxaxaxaxavaaaaaaaaaaaaaaaaaaaaaa
aaaaaaaaaaababababababababababababababababababababababababababababababababababababababababababababababababababababababababababababababababababababababaaaaaaaaaaaaaaaaaaaaavavaxaxaBaxaCaxaxaDaxaxaxavaaaaaaaaaaaaaaaaaaaaaa
aaaaaaaaabababababababababababababababababababababababababababababababababababababababababababababababababababababababaaaaaaaaabababababababababababaaaaaaaaaaaaaaaaaaaaaaavaEaxaFaxaGaAaBaHaxaIaxaxavaaaaaaaaaaaaaaaaaaaaaa
aaaaaaaaabababababababababababababababababababababababababababababababababababababababababababababababababababababaaaaaaaaaaavaJaJaJaJaJavaKaKaKaKaKavaaaaaaaaavavavavavavavaHaxaxazazaLaGazaMavavavavaaaaaaaaaaaaaaaaaaaaaa
aaaaaaabababababababababababababababababababababababababababababababababababababababababababababababababababababaaaaaaaaaaaaavaNaNaNaNaNavaNaNaNaNaNavaaaaaaaaavaxaxaEaxaxavaxaBaxaGazaxaHaDaCavaxaxavavavavavavavaaaaaaaaaa
aaaaaaababababababababababababababababababababababababababababababababababababababababababababababababaaaaaaaaaaaaaaaaaaaaaaavaNaNaNaNaNaOaNaNaNaNaNavaaaaaaaaavaxaxaxaxaxavaxaxaxaxazaBaxaxazavaRaxavaxaxaxaxaxavaaaaaaaaaa
aaaaaaabababababababababababababababababababababababababababababababababababababababababababababaaaaaaaaaaaaaaaaaaaaaaaaaaaaavaNaNaNaNaNaQaNaNaNaNaNavaaaaaaaaavaxaxaxaxaxavayaxaBaIaxaGazaxaHblaxaxblaxaxaxaxaxavaaaaaaaaaa
aaaaaaaaabababababababababababababababababababababababababababababababababababababababababaaaaaaaaaaaaaaaaaaaaaaaaaaaaaaaaaaavaNaNaNaNaNaQaNaNaNaNaNavaaaaaaaaavaxaxaxaxaxavaPaxaIaxaAaxaFaxaxavaxaxavbpaxbqaxbravaaaaaaaaaa
aaaaaaaaababababababababababababababababababababababababababababababababababababababababaaaaaaaaaaaaaaaaaaaaaaaaaaaaaaaaaaaaavaNaNaNaNaNaSaNaNaNaNaNavaaaaaaaaavaxaxaxaxaxavavavavavaxaxaxaxaxavavavavaxaxaxaxaxavaaaaaaaaaa
aaaaaaaaaaababababababababababababababababababababababababababababababababababababababaaaaaaaaaaaaaaaaaaaaaaaaaaaaaaaaaaaaaaavaNaNaNaNaNavaNaNaNaNaNavavavavavavaxaxaxaxaxaTavaxaxaxaxaxaxaxaxaxaxbsavaxaxaxaxaxavaaaaaaaaaa
aaaaaaaaaaaaabababababababababababababababababababababababababababababababababaaaaaaaaaaaaaaaaaaaaaaaaaaaaaaaaaaaaaaaaaaaaaaavaKaKaKaKaKavaJaJaJaJaJavaxaxaxaxavaxaxaxaxaxaTavaxaUaUaUaUaUaUaUaUaUaxavavavavavavavaaaaaaaaaa
aaaaaaaaaaaaababababababababababababababababababababababababababaaaaaaaaaaaaaaaaaaaaaaaaaaaaaaaaaaaaaaaaaaaaaaaaaaaaaaaaaaaaavaxaxaxaxaxaEaxaxaxaxaxaxaxaxaxaxavaVaWavaXavavavaxaUaUaUaUaUaUaUaUaUaxavaaaaaaaaaaaaaaaaaaaaaa
aaaaaaaaaaaaabababababababababababababababababababababababababaaaaaaaaaaaaaaaaaaaaaaaaaaaaaaaaaaaaaaaaaaaaaaaaaaaaaaaaaaaaaaavaxaxaFaxaxaxaxaxaxaxaxaxaxaxaxaxaEaxaxaxaxaxaxaxaxaUaUaUaUaUaUaUaUaUaxavaaaaaaaaaaaaaaaaaaaaaa
aaaaaaaaaaaaaaaaaaaaaaabababababababababababababaaaaaaaaaaaaaaaaaaaaaaaaaaaaaaaaaaaaaaaaaaaaaaaaaaaaaaaaaaaaaaaaaaaaaaaaaaaaavaxaxaxaxaxaxaxaxaxaxaxaxaxaxaxaxaxaxaxbnaxaxaxaxaxaUaUaUaUaUaUaUaUaUaxavaaaaaaaaaaaaaaaaaaaaaa
aaaaaaaaaaaaaaaaaaaaaaaaaaaaabababababaaaaaaaaaaaaaaaaaaaaaaaaaaaaaaaaaaaaaaaaaaaaaaaaaaaaaaaaaaaaaaaaaaaaaaaaaaaaaaaaaaaaaaavaxaYaZaZaZbaaxaxaxaxaxaxaxaFaxaxaxaxboboboaxaxaxaxaUaUaUaUaUaUaUaUaUbbavaaaaaaaaaaaaaaaaaaaaaa
aaaaaaaaaaaaaaaaaaaaaaaaaaaaaaaaaaabaaaaaaaaaaaaaaaaaaaaaaaaaaaaaaaaaaaaaaaaaaaaaaaaaaaaaaaaaaaaaaaaaaaaaaaaaaaaaaaaaaaaaaaaavaxbcaxaxaxbdaxaxaxaxaxaxaxaxaxaxaxaxboboboaxaxaxaxaUaUaUaUaUaUaUaUaUaxavaaaaaaaaaaaaaaaaaaaaaa
aaaaaaaaaaaaaaaaaaaaaaaaaaaaaaaaaaaaaaaaaaaaaaaaaaaaaaaaaaaaaaaaaaaaaaaaaaaaaaaaaaaaaaaaaaaaaaaaaaaaaaaaaaaaaaaaaaaaaaaaaaaaavaxbcaxaxaxbdaxaxaxaYaZbaaxaxaxaxaxaxboboboaxaxaxaxaUaUaUaUaUaUaUaUaUaxavaaaaaaaaaaaaaaaaaaaaaa
aaaaaaaaaaaaaaaaaaaaaaaaaaaaaaaaaaaaaaaaaaaaaaaaaaaaaaaaaaaaaaaaaaaaaaaaaaaaaaaaaaaaaaaaaaaaaaaaaaaaaaaaaaaaaaaaaaaaaaaaaaaaavaxbcaxaxaxbdaxaxaxbcaxbdaxaxaxaxaxaxaxaxaxaxaxavaxaUaUaUaUaUaUaUaUaUaxavaaaaaaaaaaaaaaaaaaaaaa
aaaaaaaaaaaaaaaaaaaaaaaaaaaaaaaaaaaaaaaaaaaaaaaaaaaaaaaaaaaaaaaaaaaaaaaaaaaaaaaaaaaaaaaaaaaaaaaaaaaaaaaaaaaaaaaaaaaaaaaaaaaaavaxbcaxaxaxbdaxaxaxbcaxbdaxbeaxbeaxbfaxbgaxbgaxavaxaUaUaUaUaUaUaUaUaUaxavaaaaaaaaaaaaaaaaaaaaaa
aaaaaaaaaaaaaaaaaaaaaaaaaaaaaaaaaaaaaaaaaaaaaaaaaaaaaaaaaaaaaaaaaaaaaaaaaaaaaaaaaaaaaaaaaaaaaaaaaaaaaaaaaaaaaaaaaaaaaaaaaaaaavaxbhbibibibjaxaxaxbhbibjaxaxaxaxaxaxaxaxaxaxaxavaxaxaxaxaxbkaxaxaxaxaxavaaaaaaaaaaaaaaaaaaaaaa
aaaaaaaaaaaaaaaaaaaaaaaaaaaaaaaaaaaaaaaaaaaaaaaaaaaaaaaaaaaaaaaaaaaaaaaaaaaaaaaaaaaaaaaaaaaaaaaaaaaaaaaaaaaaaaaaaaaaaaaaaaaaavavavavavavavavavavavavavavavavavavavavavavavavavavavavavavavavavavavavavaaaaaaaaaaaaaaaaaaaaaa
"}
