"a" = (/turf/simulated/floor/outwards/snow,/area/outwards)
"b" = (/obj/effect/landmark/map_data{height = 2},/turf/simulated/floor/outwards/snow,/area/outwards)
"c" = (/turf/simulated/wall,/area/space)
"d" = (/obj/effect/floor_decal/corner/blue/diagonal,/turf/simulated/floor/tiled,/area/sector_a)
"e" = (/obj/machinery/light{dir = 1},/obj/effect/floor_decal/corner/blue/diagonal,/turf/simulated/floor/tiled,/area/sector_a)
"f" = (/obj/structure/lattice,/turf/simulated/open,/area/sector_a)
"g" = (/turf/simulated/open,/area/sector_a)
"h" = (/obj/machinery/light_switch{pixel_x = 25},/obj/effect/floor_decal/corner/blue/diagonal,/turf/simulated/floor/tiled,/area/sector_a)
"i" = (/obj/effect/shuttle_landmark/upper_level,/turf/simulated/floor/outwards/snow,/area/outwards)
"j" = (/obj/machinery/light{icon_state = "tube1"; dir = 8},/obj/effect/floor_decal/corner/blue/diagonal,/turf/simulated/floor/tiled,/area/sector_a)
"k" = (/obj/effect/floor_decal/corner/blue/diagonal,/obj/structure/ladder,/turf/simulated/floor/tiled,/area/sector_a)
"l" = (/obj/machinery/door/airlock/external,/turf/simulated/floor,/area/sector_a)
"m" = (/turf/simulated/floor,/area/sector_a)
"n" = (/obj/machinery/embedded_controller/radio/simple_docking_controller{id_tag = "upper_level_dock"; pixel_x = 8; pixel_y = -25},/turf/simulated/floor,/area/sector_a)
"o" = (/obj/machinery/door/airlock/external/bolted{frequency = 1379},/turf/simulated/floor,/area/sector_a)
"p" = (/obj/machinery/atmospherics/unary/vent_pump/on,/obj/effect/floor_decal/corner/blue/diagonal,/turf/simulated/floor/tiled,/area/sector_a)
"q" = (/obj/effect/floor_decal/corner/blue/diagonal,/obj/machinery/light{icon_state = "tube1"; dir = 4},/turf/simulated/floor/tiled,/area/sector_a)
"r" = (/obj/effect/floor_decal/corner/blue/diagonal,/obj/item/weapon/rig/ce,/turf/simulated/floor/tiled,/area/sector_a)
"s" = (/obj/machinery/atmospherics/pipe/simple/visible{icon_state = "intact"; dir = 5},/obj/effect/floor_decal/corner/blue/diagonal,/turf/simulated/floor/tiled,/area/sector_a)
"t" = (/obj/machinery/atmospherics/pipe/simple/visible{icon_state = "intact"; dir = 4},/obj/effect/floor_decal/corner/blue/diagonal,/turf/simulated/floor/tiled,/area/sector_a)
"u" = (/obj/machinery/atmospherics/portables_connector{icon_state = "map_connector"; dir = 8},/obj/machinery/portable_atmospherics/canister/air,/obj/effect/floor_decal/corner/blue/diagonal,/turf/simulated/floor/tiled,/area/sector_a)
"v" = (/obj/machinery/floodlight,/turf/simulated/floor/tiled,/area/sector_a)
"w" = (/obj/effect/floor_decal/corner/blue/diagonal,/obj/item/weapon/tank/oxygen,/turf/simulated/floor/tiled,/area/sector_a)
"x" = (/obj/machinery/atmospherics/pipe/simple/visible{icon_state = "intact"; dir = 6},/obj/effect/floor_decal/corner/blue/diagonal,/turf/simulated/floor/tiled,/area/sector_a)
"y" = (/obj/machinery/atmospherics/portables_connector{icon_state = "map_connector"; dir = 8},/obj/machinery/portable_atmospherics/canister/empty,/obj/effect/floor_decal/corner/blue/diagonal,/turf/simulated/floor/tiled,/area/sector_a)
"z" = (/obj/machinery/light_switch{pixel_x = -25},/obj/effect/floor_decal/corner/blue/diagonal,/turf/simulated/floor/tiled,/area/sector_a)
"A" = (/obj/effect/floor_decal/corner/blue/diagonal,/obj/machinery/portable_atmospherics/canister/oxygen,/turf/simulated/floor/tiled,/area/sector_a)
"B" = (/obj/machinery/atmospherics/unary/vent_scrubber/on{icon_state = "map_scrubber_on"; dir = 1},/obj/effect/floor_decal/corner/blue/diagonal,/turf/simulated/floor/tiled,/area/sector_a)
"C" = (/obj/machinery/floodlight,/turf/simulated/floor/outwards/snow,/area/outwards)
"D" = (/obj/machinery/light{icon_state = "tube1"; dir = 4},/obj/effect/floor_decal/corner/blue/diagonal,/turf/simulated/floor/tiled,/area/sector_a)
"E" = (/obj/structure/cable{d2 = 2; icon_state = "0-2"; pixel_y = 0},/obj/machinery/power/apc{dir = 8; name = "west bump"; pixel_x = -24},/obj/effect/floor_decal/corner/blue/diagonal,/turf/simulated/floor/tiled,/area/sector_a)
"F" = (/obj/effect/floor_decal/corner/blue/diagonal,/obj/machinery/portable_atmospherics/canister/air,/turf/simulated/floor/tiled,/area/sector_a)
"G" = (/obj/structure/cable{d1 = 1; d2 = 2; icon_state = "1-2"; pixel_y = 0},/obj/effect/floor_decal/corner/blue/diagonal,/turf/simulated/floor/tiled,/area/sector_a)
"H" = (/obj/structure/cable,/obj/machinery/power/debug_items/infinite_generator,/obj/effect/floor_decal/corner/blue/diagonal,/turf/simulated/floor/tiled,/area/sector_a)
"I" = (/obj/item/device/analyzer,/turf/simulated/floor/outwards/snow,/area/outwards)
"J" = (/obj/item/weapon/storage/firstaid/combat,/turf/simulated/floor/outwards/snow,/area/outwards)
"K" = (/obj/item/weapon/storage/firstaid/fire,/turf/simulated/floor/outwards/snow,/area/outwards)
"L" = (/obj/structure/table/steel,/turf/simulated/floor/outwards/snow,/area/outwards)
"M" = (/obj/machinery/light,/obj/effect/floor_decal/corner/blue/diagonal,/turf/simulated/floor/tiled,/area/sector_a)

(1,1,1) = {"
aaaaaaaaaaaaaaaaaaaaaaaaaaaaaaaaaaaaaaaaaaaaaaaa
aaaaaaaaaaaaaaaaaaaaaaaaaaaaaaaaaaaaaaaaaaaaaaaa
aaaaaaaaaaaaaaaaaaaaaaaaaaaaaaaaaaaaaaaaaaaaaaaa
aaaaaaaaaaaaaaaaaaaaaaaaaaaaaaaaaaaaaaaaaaaaaaaa
aaaaaaaaaaaaaaaaaaaaaaaaaaaaaaaaaaaaaaaaaaaaaaaa
aaaaaaaaaaaaaaaaaaaaaaaaaaaaaaaaaaaaaaaaaaaaaaaa
aaaaaaaaaaaaaaaaaaaaaaaaaaaaaaaaaaaaaaaaaaaaaaaa
aaaaaaaaaaaaaaaaaaaaaaaaaaaaaaaaaaaaaaaaaaaaaaaa
aaaaaaaaaaaaaaaaaaaaaaaaaaaaaaaaaaaaaaaaaaaaaaaa
aaaaaaaaaaaaabaaacccccccccccccccaaaaaaaaaaaaaaaa
aaaaaaaaaaaaaaaaacdddeddfddedddcaaaaaaaaaaaaaaaa
aaaaaaaaaaaaaaaaacdddddfffdddddcaaaaaaaaaaaaaaaa
aaaaaaaaaaaaaaaaacdddddgggddddhccccaiaaaaaaaaaaa
aaaaaaaaaaaaaaaaacjdddkgggdddddlmnoaaaaaaaaCaaaa
aaaaaaaaaaaaaaaaacddddddddddpdqccccaaaaaaaIaaaaa
aaaaaaaaaaaaaaaaacdddddddrddstucaaaaaaaJKaaaaaaa
aaaaaaaaaaaaaaaaacddddddvddddddcaaaaaaaaaLLLaaaa
aaaaaaaaaaaaaaaaacdddddddwddxtycaaaaaaaaaaaLaaaa
aaaaaaaaaaaaaaaaaczddddddAddBddcaaaaaaaaaaaaaaaa
aaaaaaaaaaaaaaaaacjdddddddddddDcaaaaaaaaaaaaaaaa
aaaaaaaaaaaaaaaaacEdddddddddFFFcaaaaaaaaaaaaaaaa
aaaaaaaaaaaaaaaaacGdddddddddFFFcaaaaaaaaaaaaaaaa
aaaaaaaaaaaaaaaaacHddMdddddMFFFcaaaaaaaaaaaaaaaa
aaaaaaaaaaaaaaaaacccccccccccccccaaaaaaaaaaaaaaaa
aaaaaaaaaaaaaaaaaaaaaaaaaaaaaaaaaaaaaaaaaaaaaaaa
aaaaaaaaaaaaaaaaaaaaaaaaaaaaaaaaaaaaaaaaaaaaaaaa
aaaaaaaaaaaaaaaaaaaaaaaaaaaaaaaaaaaaaaaaaaaaaaaa
aaaaaaaaaaaaaaaaaaaaaaaaaaaaaaaaaaaaaaaaaaaaaaaa
aaaaaaaaaaaaaaaaaaaaaaaaaaaaaaaaaaaaaaaaaaaaaaaa
aaaaaaaaaaaaaaaaaaaaaaaaaaaaaaaaaaaaaaaaaaaaaaaa
aaaaaaaaaaaaaaaaaaaaaaaaaaaaaaaaaaaaaaaaaaaaaaaa
aaaaaaaaaaaaaaaaaaaaaaaaaaaaaaaaaaaaaaaaaaaaaaaa
"}
