"a" = (/turf/space,/area/space)
"b" = (/turf/simulated/wall,/area/space)
"c" = (/turf/simulated/floor/tiled,/area/sector_e)
"d" = (/obj/machinery/light{dir = 1},/turf/simulated/floor/tiled,/area/sector_e)
"e" = (/obj/effect/landmark{name = "tdome1"},/turf/simulated/floor/tiled,/area/sector_e)
"f" = (/obj/effect/floor_decal/industrial/hatch/yellow,/turf/simulated/floor/tiled,/area/masslift)
"g" = (/turf/simulated/wall,/area/sector_e)
"h" = (/obj/machinery/light_switch{pixel_x = 25},/turf/simulated/floor/tiled,/area/sector_e)
"i" = (/obj/machinery/light{icon_state = "tube1"; dir = 8},/turf/simulated/floor/tiled,/area/sector_e)
"j" = (/turf/simulated/wall/r_wall,/area/space)
"k" = (/obj/machinery/light{icon_state = "tube1"; dir = 4},/turf/simulated/floor/tiled,/area/sector_e)
"l" = (/obj/machinery/atmospherics/unary/vent_pump/on,/turf/simulated/floor/tiled,/area/sector_e)
"m" = (/obj/machinery/atmospherics/pipe/simple/visible{icon_state = "intact"; dir = 5},/turf/simulated/floor/tiled,/area/sector_e)
"n" = (/obj/machinery/atmospherics/pipe/simple/visible{icon_state = "intact"; dir = 4},/turf/simulated/floor/tiled,/area/sector_e)
"o" = (/obj/machinery/atmospherics/portables_connector{icon_state = "map_connector"; dir = 8},/obj/machinery/portable_atmospherics/canister/air,/turf/simulated/floor/tiled,/area/sector_e)
"p" = (/obj/machinery/light_switch{pixel_x = -25},/turf/simulated/floor/tiled,/area/sector_e)
"q" = (/obj/effect/landmark/start,/turf/simulated/floor/tiled,/area/sector_e)
"r" = (/obj/effect/landmark/test/safe_turf,/turf/simulated/floor/tiled,/area/sector_e)
"s" = (/obj/machinery/atmospherics/pipe/simple/visible{icon_state = "intact"; dir = 6},/turf/simulated/floor/tiled,/area/sector_e)
"t" = (/obj/machinery/atmospherics/portables_connector{icon_state = "map_connector"; dir = 8},/obj/machinery/portable_atmospherics/canister/empty,/turf/simulated/floor/tiled,/area/sector_e)
"u" = (/obj/machinery/atmospherics/unary/vent_scrubber/on{icon_state = "map_scrubber_on"; dir = 1},/turf/simulated/floor/tiled,/area/sector_e)
"v" = (/obj/effect/landmark{name = "JoinLate"},/turf/simulated/floor/tiled,/area/sector_e)
"w" = (/obj/structure/cable{d2 = 2; icon_state = "0-2"; pixel_y = 0},/obj/machinery/power/apc{dir = 8; name = "west bump"; pixel_x = -24},/turf/simulated/floor/tiled,/area/sector_e)
"x" = (/obj/item/clothing/gloves/insulated,/turf/simulated/floor/tiled,/area/sector_e)
"y" = (/obj/structure/cable,/obj/machinery/power/debug_items/infinite_generator,/turf/simulated/floor/tiled,/area/sector_e)
"z" = (/obj/machinery/light,/turf/simulated/floor/tiled,/area/sector_e)
"A" = (/obj/item/stack/cable_coil/blue,/obj/item/stack/cable_coil/blue,/turf/simulated/floor/tiled,/area/sector_e)
"B" = (/obj/structure/barricade,/turf/simulated/floor/tiled,/area/sector_e)
"C" = (/obj/structure/cable{d2 = 10; icon_state = "0-10"; pixel_y = 0},/turf/simulated/floor/tiled,/area/sector_e)
"D" = (/obj/machinery/power/massslift/powerplant/core,/turf/simulated/floor/tiled,/area/sector_e)
"E" = (/obj/effect/floor_decal/industrial/hatch/yellow,/obj/machinery/masslift_panel,/turf/simulated/floor/tiled,/area/masslift)
"F" = (/obj/item/weapon/wrench,/turf/simulated/floor/tiled,/area/sector_e)
"G" = (/obj/structure/cable{d1 = 1; d2 = 2; icon_state = "1-2"; pixel_y = 0},/obj/structure/cable{d2 = 2; icon_state = "0-2"; pixel_y = 0},/obj/structure/cable{d2 = 5; icon_state = "0-5"; pixel_y = 0},/obj/structure/cable{d2 = 4; icon_state = "0-4"; pixel_y = 0},/obj/structure/cable{d2 = 6; icon_state = "0-6"; pixel_y = 0},/turf/simulated/floor/tiled,/area/sector_e)
"H" = (/obj/effect/floor_decal/industrial/hatch/yellow,/obj/machinery/power/apc{dir = 8; name = "west bump"; pixel_x = -24},/turf/simulated/floor/tiled,/area/masslift)
"I" = (/obj/item/weapon/crowbar/red,/turf/simulated/floor/tiled,/area/sector_e)
"J" = (/obj/effect/landmark/test/space_turf,/turf/space,/area/space)
"K" = (/obj/structure/cable{d1 = 0; d2 = 9; icon_state = "0-9"; pixel_y = 0},/turf/simulated/floor/tiled,/area/sector_e)
"L" = (/obj/item/device/multitool,/turf/simulated/floor/tiled,/area/sector_e)
"M" = (/obj/machinery/door/blast/regular,/turf/simulated/floor/tiled/dark,/area/space)
"N" = (/turf/simulated/floor/tiled/dark,/area/space)
"O" = (/obj/machinery/door/blast/regular/open,/turf/simulated/floor,/area/space)
"P" = (/obj/machinery/door/blast/regular,/turf/simulated/floor,/area/space)
"Q" = (/turf/simulated/floor,/area/space)
"R" = (/obj/structure/grille,/obj/structure/window/phoronreinforced{icon_state = "phoronrwindow"; dir = 4},/obj/structure/window/phoronreinforced{icon_state = "phoronrwindow"; dir = 1},/obj/structure/window/phoronreinforced{icon_state = "phoronrwindow"; dir = 8},/turf/simulated/floor,/area/space)
"S" = (/obj/structure/grille,/obj/structure/window/phoronreinforced{icon_state = "phoronrwindow"; dir = 4},/obj/structure/window/phoronreinforced{icon_state = "phoronrwindow"; dir = 8},/turf/simulated/floor,/area/space)
"T" = (/obj/structure/grille,/obj/structure/window/phoronreinforced,/obj/structure/window/phoronreinforced{icon_state = "phoronrwindow"; dir = 4},/obj/structure/window/phoronreinforced{icon_state = "phoronrwindow"; dir = 8},/turf/simulated/floor,/area/space)
"U" = (/turf/simulated/open,/area/space)
"V" = (/obj/structure/grille,/obj/structure/window/reinforced{icon_state = "rwindow"; dir = 8},/obj/structure/window/reinforced{icon_state = "rwindow"; dir = 1},/obj/structure/window/reinforced,/turf/simulated/floor/tiled/dark,/area/space)
"W" = (/obj/structure/grille,/obj/structure/window/reinforced{icon_state = "rwindow"; dir = 4},/obj/structure/window/reinforced{icon_state = "rwindow"; dir = 1},/obj/structure/window/reinforced,/turf/simulated/floor/tiled/dark,/area/space)

(1,1,1) = {"
aaaaaaaaaaaaaaaaaaaaaaaaaaaaaaaaaaaaaaaaaaaaaaaaaaaaaaaaaaaaaaaaaaaaaaaaaaaaaaaaaaaaaaaaaaaaaaaaaaaa
aaaaaaaaaaaaaaaaaaaaaaaaaaaaaaaaaaaaaaaaaaaaaaaaaaaaaaaaaaaaaaaaaaaaaaaaaaaaaaaaaaaaaaaaaaaaaaaaaaaa
aaaaaaaaaaaaaaaaaaaaaaaaaaaaaaaaaaaaaaaaaaaaaaaaaaaaaaaaaaaaaaaaaaaaaaaaaaaaaaaaaaaaaaaaaaaaaaaaaaaa
aaaaaaaaaaaaaaaaaaaaaaaaaaaaaaaaaaaaaaaaaaaaaaaaaaaaaaaaaaaaaaaaaaaaaaaaaaaaaaaaaaaaaaaaaaaaaaaaaaaa
aaaaaaaaaaaaaaaaaaaaaaaaaaaaaaaaaaaaaaaaaaaaaaaaaaaaaaaaaaaaaaaaaaaaaaaaaaaaaaaaaaaaaaaaaaaaaaaaaaaa
aaaaaaaaaaaaaaaaaaaaaaaaaaaaaaaaaaaaaaaaaaaaaaaaaaaaaaaaaaaaaaaaaaaaaaaaaaaaaaaaaaaaaaaaaaaaaaaaaaaa
aaaaaaaaaaaaaaaaaaaaaaaaaaaaaaaaaaaaaaaaaaaaaaaaaaaaaaaaaaaaaaaaaaaaaaaaaaaaaaaaaaaaaaaaaaaaaaaaaaaa
aaaaaaaaaaaaaaaaaaaaaaaaaaaaaaaaaaaaaaaaaaaaaaaaaaaaaaaaaaaaaaaaaaaaaaaaaaaaaaaaaaaaaaaaaaaaaaaaaaaa
aaaaaaaaaaaaaaaaaaaaaaaaaaaaaaaaaaaaaaaaaaaaaaaaaaaaaaaaaaaaaaaaaaaaaaaaaaaaaaaaaaaaaaaaaaaaaaaaaaaa
aaaaaaaaaaaaaaaaaaaaaaaaaaaaaaaaaaaaaaaaaaaaaaaaaaaaaaaaaaaaaaaaaaaaaaaaaaaaaaaaaaaaaaaaaaaaaaaaaaaa
aaaaaaaaaaaaaaaaaaaaaaaaaaaaaaaaaaaaaaaaaaaaaaaaaaaaaaaaaaaaaaaaaaaaaaaaaaaaaaaaaaaaaaaaaaaaaaaaaaaa
aaaaaaaaaaaaaaaaaaaaaaaaaaaaaaaaaaaaaaaaaaaaaaaaaaaaaaaaaaaaaaaaaaaaaaaaaaaaaaaaaaaaaaaaaaaaaaaaaaaa
aaaaaaaaaaaaaaaaaaaaaaaaaaaaaaaaaaaaaaaaaaaaaaaaaaaaaaaaaaaaaaaaaaaaaaaaaaaaaaaaaaaaaaaaaaaaaaaaaaaa
aaaaaaaaaaaaaaaaaaaaaaaaaaaaaaaaaaaaaaaaaaaaaaaaaaaaaaaaaaaaaaaaaaaaaaaaaaaaaaaaaaaaaaaaaaaaaaaaaaaa
aaaaaaaaaaaaaaaaaaaaaaaaaaaaaaaaaaaaaaaaaaaaaaaaaaaaaaaaaaaaaaaaaaaaaaaaaaaaaaaaaaaaaaaaaaaaaaaaaaaa
aaaaaaaaaaaaaaaaaaaaaaaaaaaaaaaaaaaaaaaaaaaaaaaaaaaaaaaaaaaaaaaaaaaaaaaaaaaaaaaaaaaaaaaaaaaaaaaaaaaa
aaaaaaaaaaaaaaaaaaaaaaaaaaaaaaaaaaaaaaaaaaaaaaaaaaaaaaaaaaaaaaaaaaaaaaaaaaaaaaaaaaaaaaaaaaaaaaaaaaaa
aaaaaaaaaaaaaaaaaaaaaaaaaaaaaaaaaaaaaaaaaaaaaaaaaaaaaaaaaaaaaaaaaaaaaaaaaaaaaaaaaaaaaaaaaaaaaaaaaaaa
aaaaaaaaaaaaaaaaaaaaaaaaaaaaaaaaaaaaaaaaaaaaaaaaaaaaaaaaaaaaaaaaaaaaaaaaaaaaaaaaaaaaaaaaaaaaaaaaaaaa
aaaaaaaaaaaaaaaaaaaaaaaaaaaaaaaaaaaaaaaaaaaaaaaaaaaaaaaaaaaaaaaaaaaaaaaaaaaaaaaaaaaaaaaaaaaaaaaaaaaa
aaaaaaaaaaaaaaaaaaaaaaaaaaaaaaaaaaaaaaaaaaaaaaaaaaaaaaaaaaaaaaaaaaaaaaaaaaaaaaaaaaaaaaaaaaaaaaaaaaaa
aaaaaaaaaaaaaaaaaaaaaaaaaaaaaaaaaaaaaaaaaaaaaaaaaaaaaaaaaaaaaaaaaaaaaaaaaaaaaaaaaaaaaaaaaaaaaaaaaaaa
aaaaaaaaaaaaaaaaaaaaaaaaaaaaaaaaaaaaaaaaaaaaaaaaaaaaaaaaaaaaaaaaaaaaaaaaaaaaaaaaaaaaaaaaaaaaaaaaaaaa
aaaaaaaaaaaaaaaaaaaaaaaaaaaaaaaaaaaaaaaaaaaaaaaaaaaaaaaaaaaaaaaaaaaaaaaaaaaaaaaaaaaaaaaaaaaaaaaaaaaa
aaaaaaaaaaaaaaaaaaaaaaaaaaaaaaaaaaaaaaaaaaaaaaaaaaaaaaaaaaaaaaaaaaaaaaaaaaaaaaaaaaaaaaaaaaaaaaaaaaaa
aaaaaaaaaaaaaaaaaaaaaaaaaaaaaaaaaaaaaaaaaaaaaaaaaaaaaaaaaaaaaaaaaaaaaaaaaaaaaaaaaaaaaaaaaaaaaaaaaaaa
aaaaaaaaaaaaaaaaaaaaaaaaaaaaaaaaaaaaaaaaaaaaaaaaaaaaaaaaaaaaaaaaaaaaaaaaaaaaaaaaaaaaaaaaaaaaaaaaaaaa
aaaaaaaaaaaaaaaaaaaaaaaaaaaaaaaaaaaaaaaaaaaaaaaaaaaaaaaaaaaaaaaaaaaaaaaaaaaaaaaaaaaaaaaaaaaaaaaaaaaa
aaaaaaaaaaaaaaaaaaaaaaaaaaaaaaaaaaaaaaaaaaaaaaaaaaaaaaaaaaaaaaaaaaaaaaaaaaaaaaaaaaaaaaaaaaaaaaaaaaaa
aaaaaaaaaaaaaaaaaaaaaaaaaaaaaaaaaaaaaaaaaaaaaaaaaaaaaaaaaaaaaaaaaaaaaaaaaaaaaaaaaaaaaaaaaaaaaaaaaaaa
aaaaaaaaaaaaaaaaaaaaaaaaaaaaaaaaaaaaaaaaaaaaaaaaaaaaaaaaaaaaaaaaaaaaaaaaaaaaaaaaaaaaaaaaaaaaaaaaaaaa
aaaaaaaaaaaaaaaaaaaaaaaaaaaaaaaaaaaaaaaaaaaaaaaaaaaaaaaaaaaaaaaaaaaaaaaaaaaaaaaaaaaaaaaaaaaaaaaaaaaa
aaaaaaaaaaaaaaaaaaaaaaaaaaaaaaaaaaaaaaaaaaaaaaaaaaaaaaaaaaaaaaaaaaaaaaaaaaaaaaaaaaaaaaaaaaaaaaaaaaaa
aaaaaaaaaaaaaaaaaaaaaaaaaaaaaaaaaaaaaaaaaaaaaaaaaaaaaaaaaaaaaaaaaaaaaaaaaaaaaaaaaaaaaaaaaaaaaaaaaaaa
aaaaaaaaaaaaaaaaaaaaaaaaaaaaaaaaaaaaaaaaaaaaaaaaaaaaaaaaaaaaaaaaaaaaaaaaaaaaaaaaaaaaaaaaaaaaaaaaaaaa
aaaaaaaaaaaaaaaaaaaaaaaaaaaaaaaaaaaaaaaaaaaaaaaaaaaaaaaaaaaaaaaaaaaaaaaaaaaaaaaaaaaaaaaaaaaaaaaaaaaa
aaaaaaaaaaaaaaaaaaaaaaaaaaaaaaaaaaaaaaaaaaaaaaaaaaaaaaaaaaaaaaaaaaaaaaaaaaaaaaaaaaaaaaaaaaaaaaaaaaaa
aaaaaaaaaaaaaaaaaaaaaaaaaaaaaaaaaaaaaaaaaaaaaaaaaaaaaaaaaaaaaaaaaaaaaaaaaaaaaaaaaaaaaaaaaaaaaaaaaaaa
aaaaaaaaaaaaaaaaaaaaaaaaaaaaaaaaaaaaaaaaaaaaaaaaaaaaaaaaaaaaaaaaaaaaaaaaaaaaaaaaaaaaaaaaaaaaaaaaaaaa
aaaaaaaaaaaaaaaaaaaaaaaaaaaaaaaaaaaaaaaaaaaaaaaaaaaaaaaaaaaaaaaaaaaaaaaaaaaaaaaaaaaaaaaaaaaaaaaaaaaa
aaaaaaaaaaaaaaaaaaaaaaaaaaaaaaaaaaaaaaaaaaaaaaaaaaaaaaaaaaaaaaaaaaaaaaaaaaaaaaaaaaaaaaaaaaaaaaaaaaaa
aaaaaaaaaaaaaaaaaaaaaaaaaaaaaaaaaaaaaaaaaaaaaaaaaaaaaaaaaaaaaaaaaaaaaaaaaaaaaaaaaaaaaaaaaaaaaaaaaaaa
aaaaaaaaaaaaaaaaaaaaaaaaaaaaaaaaaaaaaaaaaaaaaaaaaaaaaaaaaaaaaaaaaaaaaaaaaaaaaaaaaaaaaaaaaaaaaaaaaaaa
aaaaaaaaaaaaaaaaaaaaaaaaaaaaaaaaaaaaaaaaaaaaaaaaaaaaaaaaaaaaaaaaaaaaaaaaaaaaaaaaaaaaaaaaaaaaaaaaaaaa
aaaaaaaaaaaaaaaaaaaaaaaaaaaaaaaaaaaaaaaaaaaaaaaaaaaaaaaaaaaaaaaaaaaaaaaaaaaaaaaaaaaaaaaaaaaaaaaaaaaa
aaaaaaaaaaaaaaaaaaaaaaaaaaaaaaaaaaaaaaaaaaaaaaaaaaaaaaaaaaaaaaaaaaaaaaaaaaaaaaaaaaaaaaaaaaaaaaaaaaaa
aaaaaaaaaaaaaaaaaaaaaaaaaaaaaaaaaaaaaaaaaaaaaaaaaaaaaaaaaaaaaaaaaaaaaaaaaaaaaaaaaaaaaaaaaaaaaaaaaaaa
aaaaaaaaaaaaaaaaaaaaaaaaaaaaaaaaaaaaaaaaaaaaaaaaaaaaaaaaaaaaaaaaaaaaaaaaaaaaaaaaaaaaaaaaaaaaaaaaaaaa
aaaaaaaaaaaaaaaaaaaaaaaaaaaaaaaaaaaaaaaaaaaaaaaaaaaaaaaaaaaaaaaaaaaaaaaaaaaaaaaaaaaaaaaaaaaaaaaaaaaa
aaaaaaaaaaaaaaaaaaaaaaaaaaaaaaaaaaaaaaaaaaaaaaaaaaaaaaaaaaaaaaaaaaaaaaaaaaaaaaaaaaaaaaaaaaaaaaaaaaaa
aaaaaaaaaaaaaaaaaaaaaaaaaaaaaaaaaaaaaaaaaaaaaaaaaaaaaaaaaaaaaaaaaaaaaaaaaaaaaaaaaaaaaaaaaaaaaaaaaaaa
aaaaaaaaaaaaaaaaaaaaaaaaaaaaaaaaaaaaaaaaaaaaaaaaaaaaaaaaaaaaaaaaaaaaaaaaaaaaaaaaaaaaaaaaaaaaaaaaaaaa
aaaaaaaaaaaaaaaaaaaaaaaaaaaaaaaaaaaaaaaaaaaaaaaaaaaaaaaaaaaaaaaaaaaaaaaaaaaaaaaaaaaaaaaaaaaaaaaaaaaa
aaaaaaaaaaaaaaaaaaaaaaaaaaaaaaaaaaaaaaaaaaaaaaaaaaaaaaaaaaaaaaaaaaaaaaaaaaaaaaaaaaaaaaaaaaaaaaaaaaaa
aaaaaaaaaaaaaaaaaaaaaaaaaaaaaaaaaaaaaaaaaaaaaaaaaaaaaaaaaaaaaaaaaaaaaaaaaaaaaaaaaaaaaaaaaaaaaaaaaaaa
aaaaaaaaaaaaaaaaaaaaaaaaaaaaaaaaaaaaaaaaaaaaaaaaaaaaaaaaaaaaaaaaaaaaaaaaaaaaaaaaaaaaaaaaaaaaaaaaaaaa
aaaaaaaaaaaaaaaaaaaaaaaaaaaaaaaaaaaaaaaaaaaaaaaaaaaaaaaaaaaaaaaaaaaaaaaaaaaaaaaaaaaaaaaaaaaaaaaaaaaa
aaaaaaaaaaaaaaaaaaaaaaaaaaaaaaaaaaaaaaaaaaaaaaaaaaaaaaaaaaaaaaaaaaaaaaaaaaaaaaaaaaaaaaaaaaaaaaaaaaaa
aaaaaaaaaaaaaaaaaaaaaaaaaaaaaaaaaaaaaaaaaaaaaaaaaaaaaaaaaaaaaaaaaaaaaaaaaaaaaaaaaaaaaaaaaaaaaaaaaaaa
aaaaaaaaaaaaaaaaaaaaaaaaaaaaaaaaaaaaaaaaaaaaaaaaaaaaaaaaaaaaaaaaaaaaaaaaaaaaaaaaaaaaaaaaaaaaaaaaaaaa
aaaaaaaaaaaaaaaaaaaaaaaaaaaaaaaaaaaaaaaaaaaaaaaaaaaaaaaaaaaaaaaaaaaaaaaaaaaaaaaaaaaaaaaaaaaaaaaaaaaa
aaaaaaaaaaaaaaaaaaaaaaaaaaaaaaaaaaaaaaaaaaaaaaaaaaaaaaaaaaaaaaaaaaaaaaaaaaaaaaaaaaaaaaaaaaaaaaaaaaaa
aaaaaaaaaaaaaaaaaaaaaaaaaaaaaaaaaaaaaaaaaaaaaaaaaaaaaaaaaaaaaaaaaaaaaaaaaaaaaaaaaaaaaaaaaaaaaaaaaaaa
aaaaaaaaaaaaaaaaaaaaaaaaaaaaaaaaaaaaaaaaaaaaaaaaaaaaaaaaaaaaaaaaaaaaaaaaaaaaaaaaaaaaaaaaaaaaaaaaaaaa
aaaaaaaaaaaaaaaaaaaaaaaaaaaaaaaaaaaaaaaaaaaaaaaaaaaaaaaaaaaaaaaaaaaaaaaaaaaaaaaaaaaaaaaaaaaaaaaaaaaa
aaaaaaaaaaaaaaaaaaaaaaaaaaaaaaaaaaaaaaaaaaaaaaaaaaaaaaaaaaaaaaaaaaaaaaaaaaaaaaaaaaaaaaaaaaaaaaaaaaaa
aaaaaaaaaaaaaaaaaaaaaaaaaaaaaaaaaaaaaaaaaaaaaaaaaaaaaaaaaaaaaaaaaaaaaaaaaaaaaaaaaaaaaaaaaaaaaaaaaaaa
aaaaaaaaaaaaaaaaaaaaaaaaaaaaaaaaaaaaaaaaaaaaaaaaaaaaaaaaaaaaaaaaaaaaaaaaaaaaaaaaaaaaaaaaaaaaaaaaaaaa
aaaaaaaaaaaaaaaaaaaaaaaaaaaaaaaaaaaaaaaaaaaaaaaaaaaaaaaaaaaaaaaaaaaaaaaaaaaaaaaaaaaaaaaaaaaaaaaaaaaa
aaaaaaaaaaaaaaaaaaaaaaaaaaaaaaaaaaaaaaaaaaaaaaaaaaaaaaaaaaaaaaaaaaaaaaaaaaaaaaaaaaaaaaaaaaaaaaaaaaaa
aaaaaaaaaaaaaaaaaaaaaaaaaaaaaaaaaaaaaaaaaaaaaaaaaaaaaaaaaaaaaaaaaaaaaaaaaaaaaaaaaaaaaaaaaaaaaaaaaaaa
aaaaaaaaaaaaaaaaaaaaaaaaaaaaaaaaaaaaaaaaaaaaaaaaaaaaaaaaaaaaaaaaaaaaaaaaaaaaaaaaaaaaaaaaaaaaaaaaaaaa
aaaaaaaaaaaaaaaaaaaaaaaaaaaaaaaaaaaaaaaaaaaaaaaaaaaaaaaaaaaaaaaaaaaaaaaaaaaaaaaaaaaaaaaaaaaaaaaaaaaa
aaaaaaaaaaaaaaaaaaaaaaaaaaaaaaaaaaaaaaaaaaaaaaaaaaaaaaaaaaaaaaaaaaaaaaaaaaaaaaaaaaaaaaaaaaaaaaaaaaaa
aaaaaaaaaaaaaaaaaaaaaaaaaaaaaaaaaaaaaaaaaaaaaaaaaaaaaaaaaaaaaaaaaaaaaaaaaaaaaaaaaaaaaaaaaaaaaaaaaaaa
aaaaaaaaaaaaaaaaaaaaaaaaaaaaaaaaaaaaaaaaaaaaaaaaaaaaaaaaaaaaaaaaaaaaaaaaaaaaaaaaaaaaaaaaaaaaaaaaaaaa
aaaaaaaaaaaaaaaaaaaaaaaaaaaaaaaaaaaaaaaaaaaaaaaaaaaaaaaaaaaaaaaaaaaaaaaaaaaaaaaaaaaaaaaaaaaaaaaaaaaa
aaaaaaaaaaaaaaaaabbbbbbbbbbbbbbbaaaaaaaaaaaaaaaaaaaaaaaaaaaaaaaaaaaaaaaaaaaaaaaaaaaaaaaajMMMMMMMjaaa
aaaaaaaaaaaaaaaaabcccdgggggdcccbaaaaaaaaaaaaaaaaaaaaaaaaaaaaaaaaaaaaaaaaaaaaaaaaaaaaaajjjNNNNNNNjjja
aaaaaaaaaaaaaaaaabceeegHfEgccccbaaaaaaaaaaaaaaaaaaaaaaaaaaaaaaaaaaaaaaaaaaaaaaaaaaaaaajNNNNNNNNNNNja
aaaaaaaaaaaaaaaaabceeegfffgccchbaaaaaaaaaaaaaaaaaaaaaaaaaaaaaaaaaaaaaaaaaaaaaaaaaaaaajjNNNNNNNNNNNjj
aaaaaaaaaaaaaaaaabieeegfffgccckbaaaaaaaaaaaaaaaaaaaaaaaaaaaaaaaaaaaaaaaaaaaaaaaaaaaaajNNNNNNNNNNNNNj
aaaaaaaaaaaaaaaaabccccgcgggclccbaaaaaaaaaaaaaaaaaaaaaaaaaaaaaajOOOOOjPPPPPjaaaajjjjjjjNNNNNNNNNNNNNj
aaaaaaaaaaaaaaaaabccccccccccmnobaaaaaaaaaaaaaaaaaaaaaaaaaaaaaajQQQQQjQQQQQjaaaajNNNNNjNNNNNNNNNNNNNj
aaaaaaaaaaaaaaaaabpcccccqccccccbaaaaaaaaaaaaaaaaaaaaaaaaaaaaaajQQQQQRQQQQQjaaaajNNNNNjNNNNNNNNNNNNNj
aaaaaaaaaaaaaaaaabccccrcccccsntbaaaaaaaaaaaaaaaaaaaaaaaaaaaaaajQQQQQSQQQQQjaaaajNNNNNjNNNNNNNNNNNNNj
aaaaaaaaaaaaaaaaabccccccxAccuccbaaaaaaaaaaaaaaaaaaaaaaaaaaaaaajQQQQQSQQQQQjaaaajNNNNNjNNNNNNNNNNNNNj
aaaaaaaaaaaaaaaaabicvvvLccBccckbaaaaaaaaaaaaaaaaaaaaaaaaaaaaaajQQQQQTQQQQQjaaaajNNNNNjjjjjNNNNNjjjjj
aaaaaaaaaaaaaaaaabwCvvvcccBccFcbaaaaaaaaaaaaaaaaaaaaaaaaaaaaaajQQQQQjQQQQQjjjjjjNNNNNNjNNNNNNNNNNNja
aaaaaaaaaaaaaaaaabGDvvvcBcIccBcbaaaaaaaaaaaaaaaaaaaaaaaaaaaaaajPPPPPjOOOOOjNNNNjNNNNNNjNUUUUUUUUUNja
aaaaaaaaaaaaaaaaabyKczccBcczcccbaaaaaaaaaaaaaaaaaaaaaaaaaaaaaajNNNNNNNNNNNNNNNNjVWjNjjjNUUUUUUUUUNja
aaaaaaaaaaaaaaaaabbbbbbbbbbbbbbbaaaaaaaaaaaaaaaaaaaaaaaaaaaaaajNNNNNNNNNNNNNNNNNNNNNNNNNUUUUUUUUUNja
aaaaaaaaaaaaaaaaaaaaaaaaaaaaaaaaaaaaaaaaaaaaaaaaaaaaaaaaaaaaaajNNNNNNNNNNNNNNNNNNNNNNNNNUUUUUUUUUNja
aaaaaaaaaaaaaaaaaaaaaaaaaaaaaaaaaaaaaaaaaaaaaaaaaaaaaaaaaaaaaajNNNNNNNNNNNNNNNNNNNNNNNNNUUUUUUUUUNja
aaaaaaaaaaaaaaaaaaaaaaJaaaaaaaaaaaaaaaaaaaaaaaaaaaaaaaaaaaaaaajNNNNNNNNNNNNNNNNNNNNNNNNNUUUUUUUUUNja
aaaaaaaaaaaaaaaaaaaaaaaaaaaaaaaaaaaaaaaaaaaaaaaaaaaaaaaaaaaaaajNNNNNNNNNNNNNNNNNNNNNNNNNUUUUUUUUUNja
aaaaaaaaaaaaaaaaaaaaaaaaaaaaaaaaaaaaaaaaaaaaaaaaaaaaaaaaaaaaaajNNNNNNNNNNNNNNNNNNNNNNNjNUUUUUUUUUNja
aaaaaaaaaaaaaaaaaaaaaaaaaaaaaaaaaaaaaaaaaaaaaaaaaaaaaaaaaaaaaajNNNNNNNNNNNNNNNNNNNNNNNjNUUUUUUUUUNja
aaaaaaaaaaaaaaaaaaaaaaaaaaaaaaaaaaaaaaaaaaaaaaaaaaaaaaaaaaaaaajNNNNNNNNNNNNNNNNNNNNNNNjNNNNNNNNNNNja
aaaaaaaaaaaaaaaaaaaaaaaaaaaaaaaaaaaaaaaaaaaaaaaaaaaaaaaaaaaaaajjjjjjjjjjjjjjjjjjjjjjjjjjjjjjjjjjjjja
"}
