"aa" = (/turf/unsimulated/outwards/stone,/area/outwards)
"ab" = (/turf/unsimulated/floor/outwards/snow,/area/outwards)
"ac" = (/obj/random/junk,/turf/unsimulated/floor/outwards/snow,/area/outwards)
"ad" = (/turf/simulated/wall/r_wall,/area/outwards)
"ae" = (/turf/simulated/floor/tiled/freezer,/area/outwards)
"af" = (/obj/effect/landmark/map_data,/turf/unsimulated/outwards/stone,/area/outwards)
"ag" = (/obj/machinery/blackbox_recorder,/turf/simulated/floor/tiled/freezer,/area/outwards)
"ah" = (/obj/random/clothing,/turf/simulated/floor/tiled/freezer,/area/outwards)
"ai" = (/obj/random/junk,/turf/simulated/floor/tiled/freezer,/area/outwards)
"aj" = (/obj/random/advdevice,/turf/simulated/floor/tiled/freezer,/area/outwards)
"ak" = (/obj/effect/gibspawner/robot,/turf/simulated/floor/tiled/freezer,/area/outwards)
"al" = (/obj/random/toy,/turf/simulated/floor/tiled/freezer,/area/outwards)
"ao" = (/obj/machinery/constructable_frame/machine_frame,/turf/simulated/floor/tiled/freezer,/area/outwards)
"ap" = (/obj/structure/firedoor_assembly,/turf/simulated/floor/tiled/freezer,/area/outwards)
"aq" = (/obj/effect/gibspawner/human,/turf/simulated/floor/tiled/freezer,/area/outwards)
"ar" = (/obj/machinery/door/blast/regular,/turf/simulated/floor/tiled/freezer,/area/outwards)
"as" = (/obj/machinery/door/airlock/cone,/turf/simulated/floor/tiled/freezer,/area/outwards)
"at" = (/obj/machinery/door/blast/regular/open,/turf/simulated/floor/tiled/freezer,/area/outwards)
"au" = (/turf/space,/area/space)
"av" = (/turf/simulated/wall/r_wall,/area/sector_a)
"aw" = (/obj/machinery/door/blast/regular,/turf/simulated/floor/plating,/area/sector_a)
"ax" = (/turf/simulated/floor/tiled/dark,/area/sector_a)
"ay" = (/turf/simulated/floor/plating,/area/sector_a)
"az" = (/obj/structure/table/rack/dark,/turf/simulated/floor/plating,/area/sector_a)
"aA" = (/obj/structure/table/steel_reinforced,/turf/simulated/floor/plating,/area/sector_a)
"aB" = (/obj/machinery/door/airlock/masslift,/turf/simulated/floor/plating,/area/sector_a/lift_zone)
"aC" = (/obj/effect/floor_decal/industrial/warning{icon_state = "warning"; dir = 9},/obj/effect/floor_decal/industrial/warning/dust{icon_state = "warning_dust"; dir = 9},/turf/simulated/floor/tiled/dark,/area/sector_a)
"aD" = (/obj/effect/floor_decal/industrial/warning/dust{icon_state = "warning_dust"; dir = 1},/turf/simulated/floor/tiled/dark,/area/sector_a)
"aE" = (/obj/machinery/light/spot{icon_state = "tube1"; dir = 1},/turf/simulated/floor/tiled/dark,/area/sector_a)
"aF" = (/obj/random/trash,/turf/simulated/floor/tiled/dark,/area/sector_a)
"aG" = (/obj/effect/floor_decal/industrial/warning/dust{icon_state = "warning_dust"; dir = 5},/turf/simulated/floor/tiled/dark,/area/sector_a)
"aH" = (/obj/effect/floor_decal/industrial/warning/dust{icon_state = "warning_dust"; dir = 8},/turf/simulated/floor/tiled/dark,/area/sector_a)
"aI" = (/obj/effect/floor_decal/industrial/warning/dust{icon_state = "warning_dust"; dir = 4},/turf/simulated/floor/tiled/dark,/area/sector_a)
"aJ" = (/obj/machinery/door/blast/regular/open,/turf/simulated/floor,/area/sector_a)
"aK" = (/obj/machinery/door/blast/regular,/turf/simulated/floor,/area/sector_a)
"aL" = (/obj/effect/floor_decal/industrial/warning{icon_state = "warning"; dir = 5},/obj/effect/floor_decal/industrial/warning/dust{icon_state = "warning_dust"; dir = 5},/turf/simulated/floor/tiled/dark,/area/sector_a)
"aM" = (/obj/effect/floor_decal/industrial/warning/dust{icon_state = "warning_dust"; dir = 6},/obj/effect/floor_decal/industrial/warning/dust{icon_state = "warning_dust"; dir = 9},/turf/simulated/floor/tiled/dark,/area/sector_a)
"aN" = (/turf/simulated/floor,/area/sector_a)
"aO" = (/obj/structure/grille,/obj/structure/window/phoronreinforced{icon_state = "phoronrwindow"; dir = 4},/obj/structure/window/phoronreinforced{icon_state = "phoronrwindow"; dir = 1},/obj/structure/window/phoronreinforced{icon_state = "phoronrwindow"; dir = 8},/turf/simulated/floor,/area/sector_a)
"aP" = (/obj/effect/floor_decal/industrial/warning/dust{icon_state = "warning_dust"; dir = 9},/obj/effect/floor_decal/industrial/warning/dust{icon_state = "warning_dust"; dir = 6},/turf/simulated/floor/tiled/dark,/area/sector_a)
"aQ" = (/obj/structure/grille,/obj/structure/window/phoronreinforced{icon_state = "phoronrwindow"; dir = 4},/obj/structure/window/phoronreinforced{icon_state = "phoronrwindow"; dir = 8},/turf/simulated/floor,/area/sector_a)
"aR" = (/turf/simulated/wall/r_wall,/area/space)
"aS" = (/obj/structure/grille,/obj/structure/window/phoronreinforced,/obj/structure/window/phoronreinforced{icon_state = "phoronrwindow"; dir = 4},/obj/structure/window/phoronreinforced{icon_state = "phoronrwindow"; dir = 8},/turf/simulated/floor,/area/sector_a)
"aT" = (/obj/machinery/suit_storage_unit/mining,/turf/simulated/floor/tiled/dark,/area/sector_a)
"aU" = (/turf/simulated/floor/tiled/dark,/area/sector_a/lift_maintenance)
"aV" = (/obj/structure/grille,/obj/structure/window/reinforced{icon_state = "rwindow"; dir = 8},/obj/structure/window/reinforced{icon_state = "rwindow"; dir = 1},/obj/structure/window/reinforced,/turf/simulated/floor/tiled/dark,/area/sector_a)
"aW" = (/obj/structure/grille,/obj/structure/window/reinforced{icon_state = "rwindow"; dir = 4},/obj/structure/window/reinforced{icon_state = "rwindow"; dir = 1},/obj/structure/window/reinforced,/turf/simulated/floor/tiled/dark,/area/sector_a)
"aX" = (/obj/machinery/door/airlock/mining,/turf/simulated/floor/tiled/dark,/area/sector_a)
"aY" = (/obj/effect/floor_decal/industrial/warning{icon_state = "warning"; dir = 10},/obj/effect/floor_decal/industrial/warning/dust{icon_state = "warning_dust"; dir = 10},/turf/simulated/floor/tiled/dark,/area/sector_a)
"aZ" = (/obj/effect/floor_decal/industrial/warning/dust,/turf/simulated/floor/tiled/dark,/area/sector_a)
"ba" = (/obj/effect/floor_decal/industrial/warning{icon_state = "warning"; dir = 6},/obj/effect/floor_decal/industrial/warning/dust{icon_state = "warning_dust"; dir = 6},/turf/simulated/floor/tiled/dark,/area/sector_a)
"bb" = (/obj/machinery/power/apc/hyper{dir = 1; icon_state = "apc0"; pixel_y = 32},/turf/simulated/floor/tiled/dark,/area/sector_a/lift_maintenance)
"bc" = (/turf/simulated/open,/area/masslift/a)
"bk" = (/obj/structure/sign/warning/secure_area,/turf/simulated/wall/r_wall,/area/sector_a)
"bl" = (/obj/machinery/light/small/red{icon_state = "bulb1"; dir = 8},/turf/simulated/floor/tiled/dark,/area/sector_a/lift_maintenance)
"bm" = (/obj/masslift/extender,/turf/simulated/floor/tiled/dark,/area/sector_a/lift_maintenance)
"bn" = (/obj/machinery/door/airlock/highsecurity,/turf/simulated/wall/r_wall,/area/sector_a)
"bo" = (/obj/machinery/door/airlock/highsecurity,/turf/simulated/wall/r_wall,/area/sector_a/lift_maintenance)
"bp" = (/obj/structure/sign/warning/fall,/turf/simulated/wall/r_wall,/area/sector_a)
"bq" = (/obj/machinery/door/airlock/masslift,/turf/simulated/floor/tiled/dark,/area/sector_a/lift_zone)
"bx" = (/obj/machinery/light{icon_state = "tube1"; dir = 1},/turf/simulated/floor/tiled/dark,/area/sector_a/lift_maintenance)
"by" = (/obj/machinery/light{icon_state = "tube1"; dir = 8},/turf/simulated/floor,/area/sector_a)
"bz" = (/obj/machinery/light{icon_state = "tube1"; dir = 4},/turf/simulated/floor,/area/sector_a)

(1,1,1) = {"
afaaaaaaaaaaaaaaaaaaaaaaaaaaaaaaaaaaaaaaaaaaaaaaaaaaaaaaaaaaaaaaaaaaaaaaaaaaaaaaaaaaaaaaaaaaaaaaaaaaaaaaaaaaaaaaaaaaaaaaaaabababababababaaaaaaaaaaaaaaaaaaaaaaaaaaaaaaaaaaaaaaaaaaaaaaaaaaaaaaaaaaaaaaaaauauauauauauauauauau
aaaaaaaaaaaaaaaaaaaaaaaaaaaaaaaaaaaaaaaaaaaaaaaaaaaaaaaaaaaaaaaaaaaaaaaaaaaaaaaaaaaaaaaaaaaaaaaaaaaaaaaaaaaaaaaaaaaaaaaaaaababababababaaaaaaaaaaaaaaaaaaaaaaaaaaaaaaaaaaaaaaaaaaaaaaaaaaaaaaaaaaaaaaaaaaauauauauauauauauauau
aaaaaaaaaaaaaaaaaaaaaaaaaaaaaaaaaaaaaaaaaaaaaaaaaaaaaaaaaaaaaaaaaaaaaaaaaaaaaaaaaaaaaaaaaaaaaaaaaaaaaaaaaaaaaaaaaaaaaaaaabababababababaaaaaaaaaaaaaaaaaaaaaaaaaaaaaaaaaaaaaaaaaaaaaaaaaaaaaaaaaaaaaaaaaaauauauauauauauauauau
aaaaaaaaaaaaaaaaaaaaaaaaaaaaaaaaaaaaaaaaaaaaaaaaaaaaaaaaaaaaaaaaaaaaaaaaaaaaaaaaaaaaaaaaaaaaaaaaaaaaaaaaaaaaaaaaaaaaaaababababababababaaaaaaaaaaaaaaaaaaaaaaaaaaaaaaaaaaaaaaaaaaaaaaaaaaaaaaaaaaaaaaaaaaauauauauauauauauauau
aaaaaaaaaaaaaaaaaaaaaaaaaaaaaaaaaaaaaaaaaaaaaaaaaaaaaaaaaaaaaaaaaaaaaaaaaaaaaaaaaaaaaaaaaaaaaaaaaaaaaaaaaaaaaaaaaaaaaaabababababababaaaaaaaaaaaaaaaaaaaaaaaaaaaaaaaaaaaaaaaaaaaaaaaaaaaaaaaaaaaaaaaaaaaaauauauauauauauauauau
aaaaaaaaaaaaaaaaaaaaaaaaaaaaaaaaaaaaaaaaaaaaaaaaaaaaaaaaaaaaaaaaaaaaaaaaaaaaaaaaaaaaaaaaaaaaaaaaaaaaaaaaaaaaaaaaaaaaabababababababaaaaaaaaaaaaaaaaaaaaaaaaaaaaaaaaaaaaaaaaaaaaaaaaaaaaaaaaaaaaaaaaaaaaaaauauauauauauauauauau
aaaaaaaaaaaaaaaaaaaaaaaaaaaaaaaaaaaaaaaaaaaaaaaaaaaaaaaaaaaaaaaaaaaaaaaaaaaaaaaaaaaaaaaaaaaaaaaaaaaaaaaaaaaaaaaaaaababababababababaaaaaaaaaaaaaaaaaaaaaaaaaaaaaaaaaaaaaaaaaaaaaaaaaaaaaaaaaaaaaaaaaaaaaaauauauauauauauauauau
aaaaaaaaaaaaaaaaaaaaaaaaaaaaaaaaaaaaaaaaaaaaaaaaaaaaaaaaaaaaaaaaaaaaaaaaaaaaaaaaaaaaaaaaaaaaaaaaaaaaaaaaaaaaaaaaaaabababababababaaaaaaaaaaaaaaaaaaaaaaaaaaaaaaaaaaaaaaaaaaaaaaaaaaaaaaaaaaaaaaaaaaaaaaaaauauauauauauauauauau
aaaaaaaaaaaaaaaaaaaaaaaaaaaaaaaaaaaaaaaaaaaaaaaaaaaaaaaaaaaaaaaaaaaaaaaaaaaaaaaaaaaaaaaaaaaaaaaaaaaaaaaaaaaaaaaaabababababababaaaaaaaaaaaaaaaaaaaaaaaaaaaaaaaaaaaaaaaaaaaaaaaaaaaaaaaaaaaaaaaaaaaaaaaaaaauauauauauauauauauau
aaaaaaaaaaaaaaaaaaaaaaaaaaaaaaaaaaaaaaaaaaaaaaaaaaaaaaaaaaaaaaaaaaaaaaaaaaaaaaaaaaaaaaaaaaaaaaaaaaaaaaaaaaaaaaabababababababaaaaaaaaaaaaaaaaaaaaaaaaaaaaaaaaaaaaaaaaaaaaaaaaaaaaaaaaaaaaaaaaaaaaaaaaaaaaauauauauauauauauauau
aaaaaaaaaaaaaaaaaaaaaaaaaaaaaaaaaaaaaaaaaaaaaaaaaaaaaaaaaaaaaaaaaaaaaaaaaaaaaaaaaaaaaaaaaaaaaaaaaaaaaaaaaaaaaaababababababaaaaaaaaaaaaaaaaaaaaaaaaaaaaaaaaaaaaaaaaaaaaaaaaaaaaaaaaaaaaaaaaaaaaaaaaaaaaaaauauauauauauauauauau
aaaaaaaaaaaaaaaaaaaaaaaaaaaaaaaaaaaaaaaaaaaaaaaaaaaaaaaaaaaaaaaaaaaaaaaaaaaaaaaaaaaaaaaaaaaaaaaaaaaaaaaaaaaaababababababaaaaaaaaaaaaaaaaaaaaaaaaaaaaaaaaaaaaaaaaaaaaaaaaaaaaaaaaaaaaaaaaaaaaaaaaaaaaaaaaauauauauauauauauauau
aaaaaaaaaaaaaaaaaaaaaaaaaaaaaaaaaaaaaaaaaaaaaaaaaaaaaaaaaaaaaaaaaaaaaaaaaaaaaaaaaaaaaaaaaaaaaaaaaaaaaaaaaaababababababaaaaaaaaaaaaaaaaaaaaaaaaaaaaaaaaaaaaaaaaaaaaaaaaaaaaaaaaaaaaaaaaaaaaaaaaaaaaaaaaaaauauauauauauauauauau
aaaaaaaaaaaaaaaaaaaaaaaaaaaaaaaaaaaaaaaaaaaaaaaaaaaaaaaaaaaaaaaaaaaaaaaaaaaaaaaaaaaaaaaaaaaaaaaaaaaaaaaaaaabababababaaaaaaaaaaaaaaaaaaaaaaaaaaaaaaaaaaaaaaaaaaaaaaaaaaaaaaaaaaaaaaaaaaaaaaaaaaaaaaaaaaaaauauauauauauauauauau
aaaaaaaaaaaaaaaaaaaaaaaaaaaaaaaaaaaaaaaaaaaaaaaaaaaaaaaaaaaaaaaaaaaaaaaaaaaaaaaaaaaaaaaaaaaaaaaaaaaaaaaaabababababaaaaaaaaaaaaaaaaaaaaaaaaaaaaaaaaaaaaaaaaaaaaaaaaaaaaaaaaaaaaaaaaaaaaaaaaaaaaaaaaaaaaaaauauauauauauauauauau
aaaaaaaaaaaaaaaaaaaaaaaaaaaaaaaaaaaaaaaaaaaaaaaaaaaaaaaaaaaaaaaaaaaaaaaaaaaaaaaaaaaaaaaaaaaaaaaaaaaaaaaaabababababaaaaaaaaaaaaaaaaaaaaaaaaaaaaaaaaaaaaaaaaaaaaaaaaaaaaaaaaaaaaaaaaaaaaaaaaaaaaaaaaaaaaaaauauauauauauauauauau
aaaaaaaaaaaaaaaaaaaaaaaaaaaaaaaaaaaaaaaaaaaaaaaaaaaaaaaaaaaaaaaaaaaaaaaaaaaaaaaaaaaaaaaaaaaaaaaaaaaaaaabababababaaaaaaaaaaaaaaaaabababababaaaaaaaaaaaaaaaaaaaaaaaaaaaaaaaaaaaaaaaaaaaaaaaaaaaaaaaaaaaaaaauauauauauauauauauau
aaaaaaaaaaaaaaaaaaaaaaaaaaaaaaaaaaaaaaaaaaaaaaaaaaaaaaaaaaaaaaaaaaaaaaaaaaaaaaaaaaaaaaaaaaaaaaaaaaaaaaabababababaaaaaaaaaaaaaaababababababababaaaaaaaaaaaaaaaaaaaaaaaaaaaaaaaaaaaaaaaaaaaaaaaaaaaaaaaaaaauauauauauauauauauau
aaaaaaaaaaaaaaaaaaaaaaaaaaaaaaaaaaaaaaaaaaaaaaaaaaaaaaaaaaaaaaaaaaaaaaaaaaaaaaaaaaaaaaaaaaaaaaaaaaaaaaaaababababaaaaaaaaaaababababababababababaaaaaaaaaaaaaaaaaaaaaaaaaaaaaaaaaaaaaaaaaaaaaaaaaaaaaaaaaaauauauauauauauauauau
aaaaaaaaaaaaaaaaaaaaaaaaaaaaaaaaaaaaaaaaaaaaaaaaaaaaaaaaaaaaaaaaaaaaaaaaaaaaaaaaaaaaaaaaaaaaaaaaaaaaaaaaababababababababaaaaababababababababababaaaaaaaaaaaaaaaaaaaaaaaaaaaaaaaaaaaaaaaaaaaaaaaaaaaaaaaaauauauauauauauauauau
aaaaaaaaaaaaaaaaaaaaaaaaaaaaaaaaaaaaaaaaaaaaaaaaaaaaaaaaaaaaaaaaaaaaaaaaaaaaaaaaaaaaaaaaaaaaaaaaaaaaaaaaababababababababababaaabababababababababaaaaaaaaaaaaaaaaaaaaaaaaaaaaaaaaaaaaaaaaaaaaaaaaaaaaaaaaauauauauauauauauauau
aaaaaaaaaaaaaaaaaaaaaaaaaaaaaaaaaaaaaaaaaaaaaaaaaaaaaaaaaaaaaaaaaaaaaaaaaaaaaaaaaaaaaaaaaaaaaaaaaaaaaaaaaaaaabababababababababababababababababaaaaaaaaaaaaaaaaaaaaaaaaaaaaaaaaaaaaaaaaaaaaaaaaaaaaaaaaaaauauauauauauauauauau
aaaaaaaaaaaaaaaaaaaaaaaaaaaaaaaaaaaaaaaaaaaaaaaaaaaaaaaaaaaaaaaaaaaaaaaaaaaaaaaaaaaaaaaaaaaaaaaaaaaaaaaaaaaaaaaaababababababababababababababaaaaaaabababababaaaaaaaaaaaaaaaaaaaaaaaaaaaaaaaaaaaaaaaaaaaaauauauauauauauauauau
aaaaaaaaaaaaaaaaaaaaaaaaaaaaaaaaaaaaaaaaaaaaaaaaaaaaaaaaaaaaaaaaaaaaaaaaaaaaaaaaaaaaaaaaaaaaaaaaaaaaaaaaaaaaaaaaaaaaabababababababababababaaaaabababababababababaaaaaaaaaaaaaaaaaaaaaaaaaaaaaaaaaaaaaaaaauauauauauauauauauau
aaaaaaaaaaaaaaaaaaaaaaaaaaaaaaaaaaaaaaaaaaaaaaaaaaaaaaaaaaaaaaaaaaaaaaaaaaaaaaaaaaaaaaaaaaaaaaaaaaaaaaaaaaaaaaaaaaaaaaababababababababababaaababababababababababababaaaaaaaaaaaaaaaaaaaaaaaaaaaaaaaaaaaaauauauauauauauauauau
aaaaaaaaaaaaaaaaaaaaaaaaaaaaaaaaaaaaaaaaaaaaaaaaaaaaaaaaaaaaaaaaaaaaaaaaaaaaaaaaaaaaaaaaaaaaaaaaaaaaaaaaaaaaaaaaaaaaaaabababababababababaaaaababababababababaaaaaaaaaaaaaaaaaaaaaaaaaaaaaaaaaaaaaaaaaaaaauauauauauauauauauau
aaaaaaaaaaaaaaaaaaaaaaaaaaaaaaaaaaaaaaaaaaaaaaaaaaaaaaaaaaaaaaaaaaaaaaaaaaaaaaaaaaaaaaaaaaaaaaaaaaaaaaaaaaaaababaaaaaaaaabababababababaaaaaaaaabababababababaaaaaaaaaaaaaaaaaaaaaaaaaaaaaaaaaaaaaaaaaaaaauauauauauauauauauau
aaaaaaaaaaaaaaaaaaaaaaaaaaaaaaaaaaaaaaaaaaaaaaaaaaaaaaaaaaaaaaaaaaaaaaaaaaaaaaaaaaaaaaaaaaaaaaaaaaaaaaaaabababababaaaaaaaaaaaaabababababaaaaaaaaaaabababababaaaaaaaaaaaaaaaaaaaaaaaaaaaaaaaaaaaaaaaaaaaaauauauauauauauauauau
aaaaaaaaaaaaaaaaaaaaaaaaaaaaaaaaaaaaaaaaaaaaaaaaaaaaaaaaaaaaaaaaaaaaaaaaaaaaaaaaaaaaaaaaaaaaaaaaaaaaaaabababababababaaaaaaaaaaaaabababababaaaaaaaaaaabababababaaaaaaaaaaaaaaaaaaaaaaaaaaaaaaaaaaaaaaaaaaauauauauauauauauauau
aaaaaaaaaaaaaaaaaaaaaaaaaaaaaaaaaaaaaaaaaaaaaaaaaaaaaaaaaaaaaaaaaaaaaaaaaaaaaaaaaaaaaaaaaaaaaaaaaaaaababababababababaaaaaaaaaaaaababababababaaaaaaaaaaababababaaaaaaaaaaaaaaaaaaaaaaaaaaaaaaaaaaaaaaaaaaauauauauauauauauauau
aaaaaaaaaaaaaaaaaaaaaaaaaaaaaaaaaaaaaaaaaaaaaaaaaaaaaaaaaaaaaaaaaaaaaaaaaaaaaaaaaaaaaaaaaaaaaaaaaaabababababaaaaabababaaaaaaaaababababababababaaaaaaaaaaababababaaaaaaaaaaaaaaaaaaaaaaaaaaaaaaaaaaaaaaaaauauauauauauauauauau
aaaaaaaaaaaaaaaaaaaaaaaaaaaaaaaaaaaaaaaaaaaaaaaaaaaaaaaaaaaaaaaaaaaaaaaaaaaaaaaaaaaaaaaaaaaaaaaaababababaaaaaaaaabababaaaaaaaaabababababababaaaaaaaaaaaaabababababababaaaaaaaaaaaaaaaaaaaaaaaaaaaaaaaaaaauauauauauauauauauau
aaaaaaaaaaaaaaaaaaaaaaaaaaaaaaaaaaaaaaaaaaaaaaaaaaaaaaaaaaaaaaaaaaaaaaaaaaaaaaaaaaaaaaaaaaaaaaaaababababaaaaaaabababaaaaaaaaaaababababababaaaaaaaaaaaaababababababababababaaaaaaaaaaaaaaaaaaaaaaaaaaaaaaauauauauauauauauauau
aaaaaaaaaaaaaaaaaaaaaaaaaaaaaaaaaaaaaaaaaaaaaaaaaaaaaaaaaaaaaaaaaaaaaaaaaaaaaaaaaaaaaaaaaaaaaaabababaaaaaaaaabababaaaaaaaaaaabababababaaaaaaaaaaaaababababababababababababaaaaaaaaaaaaaaaaaaaaaaaaaaaaaaauauauauauauauauauau
aaaaaaaaaaaaaaaaaaaaaaaaaaaaaaaaaaaaaaaaaaaaaaaaaaaaaaaaaaaaaaaaaaaaaaaaaaaaaaaaaaaaaaaaaaaaaaababaaaaaaaaaaababaaaaaaaaaaabababababaaaaaaaaaaaaababababababababababababababaaaaaaaaaaaaaaaaaaaaaaaaaaaaauauauauauauauauauau
aaaaaaaaaaaaaaaaaaaaaaaaaaaaaaaaaaaaaaaaaaaaaaaaaaaaaaaaaaaaaaaaaaaaaaaaaaaaaaaaaaaaaaaaaaaaaaababaaaaaaaaaaababaaaaaaaaabababababaaaaaaaaaaaaababababababababababababababababaaaaaaaaaaaaaaaaaaaaaaaaaaauauauauauauauauauau
aaaaaaaaaaaaaaaaaaaaaaaaaaaaaaaaaaaaaaaaaaaaaaaaaaaaaaaaaaaaaaaaaaaaaaaaaaaaaaaaaaaaaaaaaaaaababaaaaaaaaabababaaaaaaaaababababababaaaaaaaaaaabababababababababababababababababaaaaaaaaaaaaaaaaaaaaaaaaaaauauauauauauauauauau
aaaaaaaaaaaaaaaaaaaaaaaaaaaaaaaaaaaaaaaaaaaaaaaaaaaaaaaaaaaaaaaaaaaaaaaaaaaaaaaaaaaaaaaaaaababaaaaaaaaababababaaaaaaabababababababaaaaaaaaababababababababababababababababababaaaaaaaaaaaaaaaaaaaaaaaaaaauauauauauauauauauau
aaaaaaaaaaaaaaaaaaaaaaaaaaaaaaaaaaaaaaaaaaaaaaaaaaaaaaaaaaadadadadadadadadaaaaaaaaaaaaaaaaababaaaaaaaaabababaaaaaaaaababababababaaaaaaaaaaababababababababababababababababababaaaaaaaaaaaaaaaaaaaaaaaaaaauauauauauauauauauau
aaaaaaaaaaaaaaaaaaaaaaaaaaaaaaaaaaaaaaaaaaaaaaaaaaaaaaaaaaadaeaeaeaeaeagadaaaaaaaaaaaaaaabababaaaaaaababababaaaaaaaaabababababaaaaaaaaaaaaaaaaaaaaababababababababababababababaaaaaaaaaaaaaaaaaaaaaaaaaaauauauauauauauauauau
aaaaaaaaaaaaaaaaaaaaaaaaaaaaaaaaaaaaaaaaaaaaaaaaaaaaaaaaaaadahaiaeajaeaeadaaaaaaaaaaaaaaababaaaaaaaaaaababababaaaaaaabababababaaaaaaaaaaaaaaaaaaaaaaaaaaabababababababababababaaaaaaaaaaaaaaaaaaaaaaaaaaauauauauauauauauauau
aaaaaaaaaaaaaaaaaaaaaaaaaaaaaaaaaaaaaaaaaaaaaaaaaaaaaaaaaaadaeakalaiaiaeadaaaaaaaaaaaaabababaaaaaaaaaaababababaaaaaaaaababababaaaaaaaaaaaaaaaaaaaaaaaaaaaaaaabababababababababaaaaaaaaaaaaaaaaaaaaaaaaaaauauauauauauauauauau
aaaaaaaaaaaaaaaaaaaaaaaaaaaaaaaaaaaaaaaaaaaaaaaaaaaaaaaaaaadaeaiaeahaeaeadaaaaaaaaaaaaababababaaaaaaaaababababaaaaaaaaabababababaaaaaaaaaaaaaaaaaaaaaaaaaaaaabababababababababaaaaaaaaaaaaaaaaaaaaaaaaaaauauauauauauauauauau
aaaaaaaaaaaaaaaaaaaaaaaaaaaaaaaaaaaaaaaaaaaaaaaaaaaaaaaaaaadaeaeaeaeaeaiadadadadadadaaaaababaaaaaaaaabababababaaaaaaaaaaababababababababababababaaaaaaaaaaaaaaabababababababaaaaaaaaaaaaaaaaaaaaaaaaaaaaauauauauauauauauauau
aaaaaaaaaaaaaaaaaaaaaaaaaaaaaaaaaaaaaaaaaaaaaaaaaaaaaaaaaaadaeaeaeaiaeaeadaoaoaoaoadadadadabababaaabababababababaaaaaaaaabababababababababababababaaaaaaaaaaaaaaababababababaaaaaaaaaaaaaaaaaaaaaaaaaaaaauauauauauauauauauau
aaaaaaaaaaaaaaaaaaaaaaaaaaaaaaaaaaaaaaaaaaaaaaaaaaaaaaaaaaadaeaiaeaeaeapadaiaeaqaearaeaeadaaabababababababababababaaaaaaaaabababababababababababababababaaaaaaaaababababababaaaaaaaaaaaaaaaaaaaaaaaaaaaaauauauauauauauauauau
aaaaaaaaaaaaaaaaaaaaaaaaaaaaaaaaaaaaaaaaaaaaaaaaaaaaaaaaaaadaeaeaeaeaeaeasaeaeaeaeataiaeadaaaaaaaaaaabababababababababaaaaaaaaababababababababababababababaaaaababababababaaaaaaaaaaaaaaaaaaaaaaaaaaaaaaauauauauauauauauauau
aaaaaaaaaaaaaaaaaaaaaaaaaaaaaaaaaaaaaaaaaaaaaaaaaaaaaaaaaaadadadadadadadadadadadadadaratadaaaaaaaaaaaaaaababababababababaaaaaaaaaaababababababababababababababababababababaaaaaaaaaaaaaaaaaaaaaaaaaaaaaaauauauauauauauauauau
aaaaaaaaaaaaaaaaaaaaaaaaaaaaaaaaaaaaaaaaaaaaaaaaaaaaaaaaaaaaaaaaaaaaaaaaaaaaaaaaaaabababababaaaaaaaaaaaaaaaaabababababababaaaaaaaaaaaaaaababababababababababababababababaaaaaaaaaaaaaaaaaaaaaaaaaaaaaaaaauauauauauauauauauau
aaaaaaaaaaaaaaaaaaaaaaaaaaaaaaaaaaaaaaaaaaaaaaaaaaaaaaaaaaaaaaaaaaaaaaaaaaaaabababababababacabaaaaaaaaaaaaaaaaaaabababababababaaaaaaaaaaaaaaabababababababababababababaaaaaaaaaaaaaaaaaaaaaaaaaaaaaaaaaaauauauauauauauauauau
aaaaaaaaaaaaaaaaaaaaaaaaaaaaaaaaaaaaaaaaaaaaaaaaaaaaaaaaaaaaaaaaaaaaaaababababababacabababababababababaaaaaaaaaaaaabababababababaaaaaaaaaaaaababababababaaaaabababababaaaaaaaaaaaaaaaaaaaaaaaaaaaaaaaaaaauauauauauauauauauau
aaaaaaaaaaaaabababababababaaaaaaaaaaaaaaaaaaaaaaaaaaaaaaaaaaaaababababababababababababababababababababababaaaaaaaaaaabababababababababababababababababaaaaaaaaababababaaaaaaaaaaaaaaaaaaaaaaaaaaaaaaaaaaauauauauauauauauauau
aaaaaaaaaaabababababababababaaaaaaaaaaaaaaaaaaaaaaaaababababababababababababababababababababababababababababababababababababababababababababababaaaaaaaaaaaaaaababababaaaaaaaaaaaaaaaaaaaaaaaaaaaaaaaaaaauauauauauauauauauau
aaaaaaababababababababababababaaaaaaaaaaaaaaaaaaababababababababababababababababababababababababababababababababababababababababaaaaaaaaaaaaabaaaaaaaaaaaaaaabababababaaaaaaaaaaaaaaaaaaaaaaaaaaaaaaaaaaauauauauauauauauauau
abababababababababababababababababaaaaaaaaaaaaaaabababababababababababababababababababababababababababababababababababaaaaaaaaaaaaaaaaaaaaaaaaaaaaaaaaaaaaabababababababaaaaaaaaaaaaaaaaaaaaaaaaaaaaaaaaauauauauauauauauauau
abababababababababababababababababababaaaaaaaaaaaaaaaaaaababababababababababababababababababababababababababababaaaaaaaaaaaaaaaaaaaaaaaaaaaaaaaaaaaaaaababababababababababaaaaaaaaaaaaaaaaaaaaaaaaaaaaaaauauauauauauauauauau
abababababababababababababababababababababaaaaaaaaaaaaaaaaabababababababababababababababababababababaaaaaaaaaaaaaaaaaaaaaaaaaaaaaaaaaaaaaaababababababababababababababababaaaaaaaaaaaaaaaaaaaaaaaaaaaaaaauauauauauauauauauau
abababababababababaaaaaaaaababababababababababaaaaaaaaaaaaaaabababababababababababababababababaaaaaaaaaaaaaaaaaaaaaaaaaaaaaaaaaaabababababababababababababababababababababaaaaaaaaaaaaaaaaaaaaaaaaaaaaaaaaaaaaaaauauauauauau
abababababaaaaaaaaaaaaaaaaaaabababababababababababaaaaaaaaaaaaabababababababababababaaaaaaaaaaaaaaaaaaaaaaaaaaaaaaaaaaabababababababababababababababababababababababababababaaaaaaaaaaaaaaaaaaaaaaaaaaaaaaaaaaaaauauauauauau
aaaaaaaaaaaaaaaaaaaaaaaaaaaaaaabababababababababababaaaaaaaaaaaaabababababababaaaaaaaaaaaaaaaaaaaaaaaaaaabababababababababababababababababababababababababababababababababababaaaaaaaaaaaaaaaaaaaaaaaaaaaaaaaaaaauauauauauau
aaaaaaaaaaaaaaaaaaaaaaaaaaaaaaaaabababababababababababaaaaaaaaaaabababababaaaaaaaaaaaaaaaaaaaaaaababababababababababababababababababababababababababababababababababababababababaaaaaaaaaaaaaaaaaaaaaaaaaaaaaaaaauauauauauau
aaaaaaaaaaaaaaaaaaaaaaaaaaaaaaaaaaaaababababababababababaaaaaaaaaaababaaaaaaaaaaaaaaaaaaaaabababababababababababababababababababababababababababababababababababababababababababaaaaaaaaaaaaaaaaaaaaaaaaaaaaaaaaauauauauauau
aaaaaaaaaaaaaaaaaaaaaaaaaaaaaaaaaaaaaaaaaaababababababababaaaaaaaaaaaaaaaaaaaaaaaaaaabababababababababababababababababababababababababababababababababababababababababababababababaaaaaaaaaaaaaaaaaaaaaaaaaaaaaaauauauauauau
aaaaaaaaaaaaaaaaaaaaaaaaaaaaaaaaaaaaaaaaaaaaaaabababababababaaaaaaaaaaaaaaaaaaaaababababababababababababababababababababababababababababababababababababababababababababababababababaaaaaaaaaaaaaaaaaaaaaaaaaaaaauauauauauau
aaaaaaaaaaaaaaaaaaaaaaaaaaaaaaaaaaaaaaaaaaaaaaaaaaabababababababaaaaaaaaaaaaababababababababababababababababababababababababababababababababababababababababababababababababababababaaaaaaaaaaaaaaaaaaaaaaaaaaaaaaaaaaaaaaaa
aaaaaaaaaaaaaaaaaaaaaaaaaaaaaaaaaaaaaaaaaaaaaaaaaaaaaaabababababababaaaaabababababababababababababababababababababababababababababababababababababababababababababababababababababababaaaaaaaaaaaaaaaaaaaaaaaaaaaaaaaaaaaaaa
aaaaaaaaaaaaaaaaaaaaaaaaaaaaaaaaaaaaaaaaaaaaaaaaaaaaaaaaabababababababababababababababababababababababababababababababababababababababababababababababababababababababababababababababaaaaaaaaaaaaaaaaaaaaaaaaaaaaaaaaaaaaaa
aaaaaaaaaaaaaaaaaaaaaaaaaaaaaaaaaaaaaaaaaaaaaaaaaaaaaaaaaaababababababababababababababababababababababababababababababababababababababababababababababababababababababababababababababaaaaaaaaaaaaaaaaaaaaaaaaaaaaaaaaaaaaaa
aaaaaaaaaaaaaaaaaaaaaaaaaaaaaaaaaaaaaaaaaaaaaaaaaaaaaaaaaaababababababababababababababababababababababababababababababababababababababababababababababababababababababababababababababaaaaaaaaaaaaaaaaaaaaaaaaaaaaaaaaaaaaaa
aaaaaaaaaaaaaaaaaaaaaaaaaaaaaaaaaaaaaaaaaaaaaaaaaaaaaaaaababababababababababababababababababababababababababababababababababababababababababababababababababababababababababababababababaaaaaaaaaaaaaaaaaaaaaaaaaaaaaaaaaaaa
aaaaaaaaaaaaaaaaaaaaaaaaaaaaaaaaaaaaaaaaaaaaaaaaaaaaababababababababababababababababababababababababababababababababababababababababababababababababababababababababababababababababababaaaaaaaaaaaaaaaaaaaaaaaaaaaaaaaaaaaa
aaaaaaaaaaaaaaaaaaaaaaaaaaaaaaaaaaaaaaaaaaaaaaaaaaababababababababababababababababababababababababababababababababababababababababababababababababababababababababababababababababababababaaaaaaaaaaaaaaaaaaaaaaaaaaaaaaaaaa
aaaaaaaaaaaaaaaaaaaaaaaaaaaaaaaaaaaaaaaaabababababababababababababababababababababababababababababababababababababababababababababababababababababababababababababababababababababababababaaaaaaaaaaaaaaaaaaaaaaaaaaaaaaaaaa
aaaaaaaaaaaaaaaaaaaaaaaaaaaaaaaaaaabababababababababababababababababababababababababababababababababababababababababababababababababababababababababababababababababababababababababababababaaaaaaaaaaaaaaaaaaaaaaaaaaaaaaaa
aaaaaaaaaaaaaaaaaaaaaaaaaaaaabababababababababababababababababababababababababababababababababababababababababababababababababababababababababababababababababababababababababaaaaababababababaaaaaaaaaaaaaaaaaaaaaaaaaaaaaa
aaaaaaaaaaaaaaaaaaaaaaaaaaababababababababababababababababababababababababababababababababababababababababababababababababababababababababababababababababababababababababaaaaaaaaababababababaaaaaaaaaaaaaaaaaaaaaaaaaaaaaa
aaaaaaaaaaaaaaaaaaaaaaaaababababababababababababababababababababababababababababababababababababababababababababababababababababababababababababababababababababababababaaaaaaaaaaabababababababaaaaaaaaaaaaaaaaaaaaaaaaaaaa
aaaaaaaaaaaaaaaaaaaaaaabababababababababababababababababababababababababababababababababababababababababababababababababababababababababababababababababababababababaaaaaaaaaaaaavawawawawawawawavaaaaaaaaaaaaaaaaaaaaaaaaaa
aaaaaaaaaaaaaaaaabababababababababababababababababababababababababababababababababababababababababababababababababababababababababababababababababababababababababaaaaaaaaaaavavavayayayayayayayavavavaaaaaaaaaaaaaaaaaaaaaa
aaaaaaaaaaaaabababababababababababababababababababababababababababababababababababababababababababababababababababababababababababababababababababababababababaaaaaaaaaaaaaaavazayayayayayayayayayaAavaaaaaaaaaaaaaaaaaaaaaa
aaaaaaaaaaababababababababababababababababababababababababababababababababababababababababababababababababababababababababababababababababababababababaaaaaaaaaaaaaaaaaaaaavavazayayayayayayayayayaAavavaaaaaaaaaaaaaaaaaaaa
aaaaaaaaabababababababababababababababababababababababababababababababababababababababababababababababababababababababaaaaaaaaabababababababababababaaaaaaaaaaaaaaaaaaaaaaavazazayayayayayayayayayaRaRaRaRaRaRaRaaaaaaaaaaaa
aaaaaaaaabababababababababababababababababababababababababababababababababababababababababababababababababababababaaaaaaaaaaavaJaJaJaJaJavaKaKaKaKaKavaaaaaaaaavavavavavavavayayayayayayayayayayayaRaUaUbxaUbbaRaaaaaaaaaaaa
aaaaaaabababababababababababababababababababababababababababababababababababababababababababababababababababababaaaaaaaaaaaaavbyaNaNaNaNavaNaNaNaNbzavaaaaaaaaavaxaxaEaxaxavazazazazayayayayayavaRaRaUaUaUaUaUaRaaaaaaaaaaaa
aaaaaaababababababababababababababababababababababababababababababababababababababababababababababababaaaaaaaaaaaaaaaaaaaaaaavaNaNaNaNaNaOaNaNaNaNaNavaaaaaaaaavaxaxaxaxaxavayayayayayayayayaybkblaRaUaUbmaUaUaRaaaaaaaaaaaa
aaaaaaabababababababababababababababababababababababababababababababababababababababababababababaaaaaaaaaaaaaaaaaaaaaaaaaaaaavaNaNaNaNaNaQaNaNaNaNaNavaaaaaaaaavaxaxaxaxaxavazazazazayayayayaybnaUboaUaUaUaUaUaRaaaaaaaaaaaa
aaaaaaaaabababababababababababababababababababababababababababababababababababababababababaaaaaaaaaaaaaaaaaaaaaaaaaaaaaaaaaaavaNaNaNaNaNaQaNaNaNaNaNavaaaaaaaaavaxaxaxaxaxavayayayayayayayayaybpaUaRaUaUaUaUaUaRaaaaaaaaaaaa
aaaaaaaaababababababababababababababababababababababababababababababababababababababababaaaaaaaaaaaaaaaaaaaaaaaaaaaaaaaaaaaaavaNaNaNaNaNaSaNaNaNaNaNavaaaaaaaaavaxaxaxaxaxavaRaRaRaRaBaBaBaBaBaRaRaRaRaRaRaRaRaRaaaaaaaaaaaa
aaaaaaaaaaababababababababababababababababababababababababababababababababababababababaaaaaaaaaaaaaaaaaaaaaaaaaaaaaaaaaaaaaaavbyaNaNaNaNavaNaNaNaNbzavavavavavavaxaxaxaxaxaTaRbcbcbcbcbcbcbcbcbcbcbcaRaaaaaaaaaaaaaaaaaaaaaa
aaaaaaaaaaaaabababababababababababababababababababababababababababababababababaaaaaaaaaaaaaaaaaaaaaaaaaaaaaaaaaaaaaaaaaaaaaaavaKaKaKaKaKavaJaJaJaJaJavaxaxaxaxavaxaxaxaxaxaTaRbcbcbcbcbcbcbcbcbcbcbcaRaaaaaaaaaaaaaaaaaaaaaa
aaaaaaaaaaaaababababababababababababababababababababababababababaaaaaaaaaaaaaaaaaaaaaaaaaaaaaaaaaaaaaaaaaaaaaaaaaaaaaaaaaaaaavaxaxaxaxaxaEaxaxaxaxaxaxaxaxaxaxavaVaWavaXavavaRbcbcbcbcbcbcbcbcbcbcbcaRaaaaaaaaaaaaaaaaaaaaaa
aaaaaaaaaaaaabababababababababababababababababababababababababaaaaaaaaaaaaaaaaaaaaaaaaaaaaaaaaaaaaaaaaaaaaaaaaaaaaaaaaaaaaaaavaxaxaFaxaxaxaxaxaxaxaxaxaxaxaxaxaEaxaxaxaxaxaxbqbcbcbcbcbcbcbcbcbcbcbcaRaaaaaaaaaaaaaaaaaaaaaa
aaaaaaaaaaaaaaaaaaaaaaabababababababababababababaaaaaaaaaaaaaaaaaaaaaaaaaaaaaaaaaaaaaaaaaaaaaaaaaaaaaaaaaaaaaaaaaaaaaaaaaaaaavaxaxaxaxaxaxaxaxaxaxaxaxaxaxaxaxaxaxaxaxaxaxaxbqbcbcbcbcbcbcbcbcbcbcbcaRaaaaaaaaaaaaaaaaaaaaaa
aaaaaaaaaaaaaaaaaaaaaaaaaaaaabababababaaaaaaaaaaaaaaaaaaaaaaaaaaaaaaaaaaaaaaaaaaaaaaaaaaaaaaaaaaaaaaaaaaaaaaaaaaaaaaaaaaaaaaavaxaCaDaDaDaGaxaxaxaxaxaxaxaFaxaxaxaxaxaxaxaxaxbqbcbcbcbcbcbcbcbcbcbcbcaRaaaaaaaaaaaaaaaaaaaaaa
aaaaaaaaaaaaaaaaaaaaaaaaaaaaaaaaaaabaaaaaaaaaaaaaaaaaaaaaaaaaaaaaaaaaaaaaaaaaaaaaaaaaaaaaaaaaaaaaaaaaaaaaaaaaaaaaaaaaaaaaaaaavaxaHaxaxaxaIaxaxaxaxaxaxaxaxaxaxaxaxaxaxaxaxaxbqbcbcbcbcbcbcbcbcbcbcbcaRaaaaaaaaaaaaaaaaaaaaaa
aaaaaaaaaaaaaaaaaaaaaaaaaaaaaaaaaaaaaaaaaaaaaaaaaaaaaaaaaaaaaaaaaaaaaaaaaaaaaaaaaaaaaaaaaaaaaaaaaaaaaaaaaaaaaaaaaaaaaaaaaaaaavaxaHaxaxaxaIaxaxaxaCaDaLaxaxaxaxaxaxaxaxaxaxaxbqbcbcbcbcbcbcbcbcbcbcbcaRaaaaaaaaaaaaaaaaaaaaaa
aaaaaaaaaaaaaaaaaaaaaaaaaaaaaaaaaaaaaaaaaaaaaaaaaaaaaaaaaaaaaaaaaaaaaaaaaaaaaaaaaaaaaaaaaaaaaaaaaaaaaaaaaaaaaaaaaaaaaaaaaaaaavaxaHaxaxaxaIaxaxaxaHaxaIaxaxaxaxaxaxaxaxaxaxaxaRbcbcbcbcbcbcbcbcbcbcbcaRaaaaaaaaaaaaaaaaaaaaaa
aaaaaaaaaaaaaaaaaaaaaaaaaaaaaaaaaaaaaaaaaaaaaaaaaaaaaaaaaaaaaaaaaaaaaaaaaaaaaaaaaaaaaaaaaaaaaaaaaaaaaaaaaaaaaaaaaaaaaaaaaaaaavaxaHaxaxaxaIaxaxaxaHaxaIaxaMaxaPaxaPaxaPaxaPaxaRbcbcbcbcbcbcbcbcbcbcbcaRaaaaaaaaaaaaaaaaaaaaaa
aaaaaaaaaaaaaaaaaaaaaaaaaaaaaaaaaaaaaaaaaaaaaaaaaaaaaaaaaaaaaaaaaaaaaaaaaaaaaaaaaaaaaaaaaaaaaaaaaaaaaaaaaaaaaaaaaaaaaaaaaaaaavaxaYaZaZaZbaaxaxaxaYaZbaaxaxaxaxaxaxaxaxaxaxaxaRbcbcbcbcbcbcbcbcbcbcbcaRaaaaaaaaaaaaaaaaaaaaaa
aaaaaaaaaaaaaaaaaaaaaaaaaaaaaaaaaaaaaaaaaaaaaaaaaaaaaaaaaaaaaaaaaaaaaaaaaaaaaaaaaaaaaaaaaaaaaaaaaaaaaaaaaaaaaaaaaaaaaaaaaaaaavavavavavavavavavavavavavavavavavavavavavavavavaRaRaRaRaRaRaRaRaRaRaRaRaRaaaaaaaaaaaaaaaaaaaaaa
"}
